AAAATTCTTTC -> AAATTCTTTCA
AAACAACCGAA -> AACAACCGAAT
AAACAATGGTG -> AACAATGGTGG
AAACACCGAAT -> AACACCGAATG
AAACATAAACA -> AACATAAACAA
AAACCCCTAGA -> AACCCCTAGAG
AAACCGCAAAC -> AACCGCAAACG
AAACGAAATTG -> AACGAAATTGG
AAACGCGGAGT -> AACGCGGAGTC
AAACGCTTCCT -> AACGCTTCCTT
AAACGGGCGAG -> AACGGGCGAGA
AAAGAAGCCCG -> AAGAAGCCCGT
AAAGCGGCAGC -> AAGCGGCAGCC
AAAGGACACCC -> AAGGACACCCC
AAAGGAGTGCC -> AAGGAGTGCCC
AAAGGCAGGAT -> AAGGCAGGATA
AAAGGGGGCTG -> AAGGGGGCTGC
AAATAACGGCA -> AATAACGGCAC
AAATAGCTGCC -> AATAGCTGCCC
AAATCCAGATA -> AATCCAGATAA
AAATCCGCCTT -> AATCCGCCTTA
AAATCGAGCGA -> AATCGAGCGAG
AAATCGGTCGT -> AATCGGTCGTG
AAATTCTTTCA -> AATTCTTTCAC
AAATTGCATTG -> AATTGCATTGG
AAATTGGGAAA -> AATTGGGAAAC
AACAACCGAAT -> ACAACCGAATG
AACAATATACG -> ACAATATACGA
AACAATGGTGG -> ACAATGGTGGC
AACACCGAATG -> ACACCGAATGA
AACACCGCAGC -> ACACCGCAGCG
AACACGATCAT -> ACACGATCATC
AACATAAACAA -> ACATAAACAAC
AACATACGATG -> ACATACGATGC
AACATGCTCAG -> ACATGCTCAGG
AACCACCGATC -> ACCACCGATCC
AACCATCGTGC -> ACCATCGTGCG
AACCCCCGGTC -> ACCCCCGGTCG
AACCCCTAGAG -> ACCCCTAGAGC
AACCGAATGGG -> ACCGAATGGGT
AACCGCAAACG -> ACCGCAAACGC
AACCGCCCAAA -> ACCGCCCAAAC
AACGAAATTGG -> ACGAAATTGGG
AACGACGACAG -> ACGACGACAGA
AACGAGCAGTC -> ACGAGCAGTCA
AACGAGGATAT -> ACGAGGATATA
AACGAGTACCG -> ACGAGTACCGT
AACGCGGAGTC -> ACGCGGAGTCT
AACGCTTCCTT -> ACGCTTCCTTT
AACGGCACTGA -> ACGGCACTGAT
AACGGCCTATA -> ACGGCCTATAT
AACGGGCGAGA -> ACGGGCGAGAG
AACGTCAGGCA -> ACGTCAGGCAA
AACGTCTCGTG -> ACGTCTCGTGT
AACGTCTGTTA -> ACGTCTGTTAA
AACGTGTCCAG -> ACGTGTCCAGA
AACTATCGCAG -> ACTATCGCAGC
AACTCCTTGCG -> ACTCCTTGCGA
AACTCTAACAC -> ACTCTAACACC
AACTGACGTGT -> ACTGACGTGTA
AACTTTCCCTG -> ACTTTCCCTGG
AACTTTCTGTC -> ACTTTCTGTCA
AAGAAGCCCGT -> AGAAGCCCGTG
AAGCCCGTGAT -> AGCCCGTGATA
AAGCGAAGCGT -> AGCGAAGCGTT
AAGCGGCAGCC -> AGCGGCAGCCC
AAGCGTTACTT -> AGCGTTACTTT
AAGCTAGACTG -> AGCTAGACTGG
AAGGACACCCC -> AGGACACCCCA
AAGGAGTGCCC -> AGGAGTGCCCG
AAGGCAGCAAA -> AGGCAGCAAAG
AAGGCAGGATA -> AGGCAGGATAT
AAGGGAAGTCG -> AGGGAAGTCGA
AAGGGACTCGT -> AGGGACTCGTC
AAGGGATTTAG -> AGGGATTTAGT
AAGGGGGCTGC -> AGGGGGCTGCT
AAGGTCGCAAA -> AGGTCGCAAAT
AAGGTTACGCA -> AGGTTACGCAA
AAGTCATTAAA -> AGTCATTAAAT
AAGTCGACTAC -> AGTCGACTACC
AAGTGAGCACT -> AGTGAGCACTC
AAGTGCTAGTA -> AGTGCTAGTAC
AAGTGCTTCCC -> AGTGCTTCCCA
AAGTGTAAGTG -> AGTGTAAGTGA
AATAACGGCAC -> ATAACGGCACT
AATAATTTGGC -> ATAATTTGGCA
AATAGCTGCCC -> ATAGCTGCCCG
AATATACGACA -> ATATACGACAG
AATCATCCGCA -> ATCATCCGCAC
AATCATTCAAC -> ATCATTCAACT
AATCCAGATAA -> ATCCAGATAAA
AATCCGCCTTA -> ATCCGCCTTAT
AATCGAGCGAG -> ATCGAGCGAGC
AATCGATGATT -> ATCGATGATTG
AATCGGTATTG -> ATCGGTATTGT
AATCGGTCGTG -> ATCGGTCGTGA
AATCTCCCTAC -> ATCTCCCTACG
AATCTTGACGT -> ATCTTGACGTA
AATGACACCGT -> ATGACACCGTT
AATGACCCTTG -> ATGACCCTTGC
AATGCCCAATT -> ATGCCCAATTG
AATGCGTCTGC -> ATGCGTCTGCC
AATGGGCTGTT -> ATGGGCTGTTT
AATGGGTCGAA -> ATGGGTCGAAA
AATGGGTTTCG -> ATGGGTTTCGC
AATGGTGGCTC -> ATGGTGGCTCA
AATTCTTTCAC -> ATTCTTTCACA
AATTGCATTGG -> ATTGCATTGGA
AATTGCGGCTA -> ATTGCGGCTAG
AATTGGGAAAC -> ATTGGGAAACG
AATTTGGCACA -> ATTTGGCACAC
AATTTTCCGCA -> ATTTTCCGCAC
AATTTTCGGTA -> ATTTTCGGTAA
ACAAAGGACAC -> CAAAGGACACC
ACAAATAGCTG -> CAAATAGCTGC
ACAAATCCAGA -> CAAATCCAGAT
ACAACCGAATG -> CAACCGAATGG
ACAACGAGGAT -> CAACGAGGATA
ACAAGTCATTA -> CAAGTCATTAA
ACAAGTGTAAG -> CAAGTGTAAGT
ACAATATACGA -> CAATATACGAC
ACAATCTTGAC -> CAATCTTGACG
ACAATGGTGGC -> CAATGGTGGCT
ACACAAGTCAT -> CACAAGTCATT
ACACAATCTTG -> CACAATCTTGA
ACACACGGTGC -> CACACGGTGCA
ACACATGAATG -> CACATGAATGC
ACACCCCACGA -> CACCCCACGAC
ACACCCGTATA -> CACCCGTATAG
ACACCGAATGA -> CACCGAATGAC
ACACCGAGACA -> CACCGAGACAC
ACACCGCAGCG -> CACCGCAGCGG
ACACCGTTGTA -> CACCGTTGTAC
ACACGAAAGAA -> CACGAAAGAAG
ACACGATCATC -> CACGATCATCG
ACACGGTGCAA -> CACGGTGCAAT
ACACTAACATA -> CACTAACATAC
ACACTAACGAG -> CACTAACGAGC
ACACTCGCGCT -> CACTCGCGCTT
ACAGACAAGTG -> CAGACAAGTGT
ACAGAGACACA -> CAGAGACACAT
ACAGAGTCTGT -> CAGAGTCTGTA
ACAGATTGCTG -> CAGATTGCTGC
ACAGCATATTC -> CAGCATATTCT
ACAGGACCGGC -> CAGGACCGGCT
ACAGGTCGTGG -> CAGGTCGTGGA
ACAGGTTCGCG -> CAGGTTCGCGA
ACATAAACAAC -> CATAAACAACC
ACATACGATGC -> CATACGATGCG
ACATAGCACAG -> CATAGCACAGG
ACATATACGCG -> CATATACGCGT
ACATATCCGTG -> CATATCCGTGG
ACATCCAGACT -> CATCCAGACTA
ACATGAATGCG -> CATGAATGCGT
ACATGCTCAGG -> CATGCTCAGGG
ACCAAGGCAGC -> CCAAGGCAGCA
ACCACCGATCC -> CCACCGATCCC
ACCAGATTTCG -> CCAGATTTCGC
ACCATCGTGCG -> CCATCGTGCGT
ACCCACCTTTT -> CCCACCTTTTT
ACCCAGGTGCG -> CCCAGGTGCGC
ACCCCACGACG -> CCCCACGACGA
ACCCCCGGTCG -> CCCCCGGTCGA
ACCCCTAGAGC -> CCCCTAGAGCG
ACCCGCTCCAG -> CCCGCTCCAGG
ACCCGCTTGCG -> CCCGCTTGCGC
ACCCGTATAGA -> CCCGTATAGAC
ACCCTCTGGTA -> CCCTCTGGTAT
ACCCTTAAAGG -> CCCTTAAAGGG
ACCCTTGCTCC -> CCCTTGCTCCC
ACCGAATGACA -> CCGAATGACAC
ACCGAATGGGT -> CCGAATGGGTC
ACCGAGACACG -> CCGAGACACGA
ACCGATCCCTA -> CCGATCCCTAA
ACCGCAAACGC -> CCGCAAACGCG
ACCGCAGCGGA -> CCGCAGCGGAC
ACCGCCCAAAC -> CCGCCCAAACA
ACCGGCTCCTC -> CCGGCTCCTCG
ACCGGTTCACT -> CCGGTTCACTC
ACCGTTGAGTG -> CCGTTGAGTGT
ACCGTTGTACT -> CCGTTGTACTG
ACCTAACGACG -> CCTAACGACGA
ACCTCTTGCCG -> CCTCTTGCCGT
ACCTTTTTGGC -> CCTTTTTGGCA
ACGAAAGAAGC -> CGAAAGAAGCC
ACGAAATTGGG -> CGAAATTGGGA
ACGAACCGCCC -> CGAACCGCCCA
ACGAAGCTAGA -> CGAAGCTAGAC
ACGACACTAAC -> CGACACTAACG
ACGACAGAGAC -> CGACAGAGACA
ACGACAGATTG -> CGACAGATTGC
ACGACGACACT -> CGACGACACTA
ACGACGACAGA -> CGACGACAGAT
ACGAGCAGTCA -> CGAGCAGTCAA
ACGAGGATATA -> CGAGGATATAG
ACGAGTACCGT -> CGAGTACCGTT
ACGAGTCGCTT -> CGAGTCGCTTT
ACGATCATCGA -> CGATCATCGAA
ACGATGCGATA -> CGATGCGATAA
ACGCAAAATTC -> CGCAAAATTCT
ACGCCTCCTTC -> CGCCTCCTTCC
ACGCGGAGTCT -> CGCGGAGTCTC
ACGCGTGGCCG -> CGCGTGGCCGT
ACGCTAGGACT -> CGCTAGGACTA
ACGCTTCCTTT -> CGCTTCCTTTT
ACGGAACGAGT -> CGGAACGAGTA
ACGGCACTGAT -> CGGCACTGATA
ACGGCCTATAT -> CGGCCTATATG
ACGGCTGTTAA -> CGGCTGTTAAT
ACGGGCGAGAG -> CGGGCGAGAGT
ACGGTGCAATG -> CGGTGCAATGG
ACGTATGGAGT -> CGTATGGAGTT
ACGTATTTCTT -> CGTATTTCTTG
ACGTCAGGCAA -> CGTCAGGCAAC
ACGTCTCGTGT -> CGTCTCGTGTT
ACGTCTGTTAA -> CGTCTGTTAAC
ACGTGCTAAGG -> CGTGCTAAGGG
ACGTGTAGGTT -> CGTGTAGGTTG
ACGTGTCCAGA -> CGTGTCCAGAC
ACGTTCCTCAC -> CGTTCCTCACA
ACTAACATACG -> CTAACATACGA
ACTAACGAGCA -> CTAACGAGCAG
ACTAAGTGCTA -> CTAAGTGCTAG
ACTACATCCAG -> CTACATCCAGA
ACTACCAAGGC -> CTACCAAGGCA
ACTACCAGATT -> CTACCAGATTT
ACTACCCTTAA -> CTACCCTTAAA
ACTAGAATCGA -> CTAGAATCGAT
ACTATAGCGAG -> CTATAGCGAGA
ACTATCACACC -> CTATCACACCG
ACTATCGCAGC -> CTATCGCAGCC
ACTCAGCGGTT -> CTCAGCGGTTT
ACTCCTTGCGA -> CTCCTTGCGAA
ACTCGCGCTTG -> CTCGCGCTTGT
ACTCGGCTGCG -> CTCGGCTGCGC
ACTCGTCCAGC -> CTCGTCCAGCC
ACTCTAACACC -> CTCTAACACCG
ACTCTTGGGGG -> CTCTTGGGGGG
ACTGAACTGAC -> CTGAACTGACG
ACTGACGTGTA -> CTGACGTGTAG
ACTGATACTGG -> CTGATACTGGT
ACTGCACCCAG -> CTGCACCCAGG
ACTGGAATGAC -> CTGGAATGACC
ACTGGATCAGA -> CTGGATCAGAC
ACTGGTGCCTG -> CTGGTGCCTGT
ACTGGTGCGGT -> CTGGTGCGGTA
ACTTCCATCGA -> CTTCCATCGAA
ACTTCTGCCTG -> CTTCTGCCTGC
ACTTGTCTCCT -> CTTGTCTCCTC
ACTTTCCCTGG -> CTTTCCCTGGT
ACTTTCTGTCA -> CTTTCTGTCAC
ACTTTGGGCGA -> CTTTGGGCGAT
AGAAATCCGCC -> GAAATCCGCCT
AGAACTCTAAC -> GAACTCTAACA
AGAAGCCCGTG -> GAAGCCCGTGA
AGAATCGATGA -> GAATCGATGAT
AGACAAGTGTA -> GACAAGTGTAA
AGACACACGGT -> GACACACGGTG
AGACACATGAA -> GACACATGAAT
AGACACCCGTA -> GACACCCGTAT
AGACACGAAAG -> GACACGAAAGA
AGACAGCATAT -> GACAGCATATT
AGACCCTCTGG -> GACCCTCTGGT
AGACCGGTTCA -> GACCGGTTCAC
AGACGTGCTAA -> GACGTGCTAAG
AGACGTTCCTC -> GACGTTCCTCA
AGACTAAGTGC -> GACTAAGTGCT
AGACTGGAATG -> GACTGGAATGA
AGAGACACATG -> GAGACACATGA
AGAGCGGACTA -> GAGCGGACTAG
AGAGGAGCGTT -> GAGGAGCGTTG
AGAGTAAAGGA -> GAGTAAAGGAG
AGAGTCTGTAC -> GAGTCTGTACT
AGATAAACGCT -> GATAAACGCTT
AGATAACTATC -> GATAACTATCG
AGATAGATAAC -> GATAGATAACT
AGATGCATTTC -> GATGCATTTCG
AGATGGGATGC -> GATGGGATGCA
AGATTAAACCC -> GATTAAACCCC
AGATTGCTGCC -> GATTGCTGCCC
AGATTTCGCTT -> GATTTCGCTTG
AGCAAAGCGGC -> GCAAAGCGGCA
AGCACACAATC -> GCACACAATCT
AGCACAGGTCG -> GCACAGGTCGT
AGCACTCTTGG -> GCACTCTTGGG
AGCAGGCTCAT -> GCAGGCTCATT
AGCAGTCAATT -> GCAGTCAATTT
AGCATATTCTT -> GCATATTCTTG
AGCATCGGGAC -> GCATCGGGACG
AGCATTCCAGT -> GCATTCCAGTG
AGCCAGCATCG -> GCCAGCATCGG
AGCCCGTGATA -> GCCCGTGATAG
AGCCCTAGCAG -> GCCCTAGCAGG
AGCCCTGTCTA -> GCCCTGTCTAA
AGCCTATCTAC -> GCCTATCTACG
AGCGAAGCGTT -> GCGAAGCGTTA
AGCGAGACCCT -> GCGAGACCCTC
AGCGAGCGCGT -> GCGAGCGCGTG
AGCGCAAGGGA -> GCGCAAGGGAA
AGCGCGCGGGG -> GCGCGCGGGGG
AGCGCGTGCTA -> GCGCGTGCTAG
AGCGGACCTCT -> GCGGACCTCTT
AGCGGACTAGA -> GCGGACTAGAA
AGCGGCAGCCC -> GCGGCAGCCCT
AGCGGTTTCTG -> GCGGTTTCTGA
AGCGTGGATAC -> GCGTGGATACA
AGCGTTACTTT -> GCGTTACTTTG
AGCGTTCCCTC -> GCGTTCCCTCG
AGCGTTGGCCG -> GCGTTGGCCGT
AGCTAGACTGG -> GCTAGACTGGA
AGCTGCCCGCG -> GCTGCCCGCGA
AGCTTTACGAG -> GCTTTACGAGT
AGGACACCCCA -> GGACACCCCAC
AGGACCGGCTC -> GGACCGGCTCC
AGGACTACCCT -> GGACTACCCTT
AGGAGCGCAAG -> GGAGCGCAAGG
AGGAGCGTTGG -> GGAGCGTTGGC
AGGAGTGCCCG -> GGAGTGCCCGA
AGGATATAGTA -> GGATATAGTAT
AGGATATTGTA -> GGATATTGTAG
AGGCAACACGA -> GGCAACACGAT
AGGCACTGGAT -> GGCACTGGATC
AGGCAGCAAAG -> GGCAGCAAAGC
AGGCAGGATAT -> GGCAGGATATT
AGGCCGCGAAC -> GGCCGCGAACC
AGGCGAAACAC -> GGCGAAACACC
AGGCGGAAGCG -> GGCGGAAGCGA
AGGCGGCCTCA -> GGCGGCCTCAG
AGGCTCATTTG -> GGCTCATTTGG
AGGGAAGTCGA -> GGGAAGTCGAC
AGGGACTCGTC -> GGGACTCGTCC
AGGGATTTAGT -> GGGATTTAGTG
AGGGCATACGC -> GGGCATACGCC
AGGGCTTATAG -> GGGCTTATAGA
AGGGGGCTGCT -> GGGGGCTGCTT
AGGGGTGCCAA -> GGGGTGCCAAA
AGGGTCATCAC -> GGGTCATCACT
AGGTCGCAAAT -> GGTCGCAAATC
AGGTCGGCCCT -> GGTCGGCCCTT
AGGTCGTGGAT -> GGTCGTGGATA
AGGTGCGCACG -> GGTGCGCACGA
AGGTTACGCAA -> GGTTACGCAAA
AGGTTCGCGAG -> GGTTCGCGAGA
AGGTTGATTAG -> GGTTGATTAGG
AGGTTTACAGG -> GGTTTACAGGA
AGTAAAGGAGT -> GTAAAGGAGTG
AGTACCGTTGA -> GTACCGTTGAG
AGTACCTAACG -> GTACCTAACGA
AGTAGGCGAAA -> GTAGGCGAAAC
AGTATGAGACA -> GTATGAGACAC
AGTATGCAGGC -> GTATGCAGGCG
AGTCAATTTTC -> GTCAATTTTCG
AGTCATTAAAT -> GTCATTAAATC
AGTCGACTACC -> GTCGACTACCA
AGTCGCTTTCC -> GTCGCTTTCCG
AGTCTCTCCAC -> GTCTCTCCACT
AGTCTGTACTG -> GTCTGTACTGA
AGTGACTTGTC -> GTGACTTGTCT
AGTGAGCACTC -> GTGAGCACTCT
AGTGCCCGATG -> GTGCCCGATGG
AGTGCTAGTAC -> GTGCTAGTACC
AGTGCTTCCCA -> GTGCTTCCCAC
AGTGGAGACAG -> GTGGAGACAGC
AGTGGTTCATT -> GTGGTTCATTC
AGTGTAAGTGA -> GTGTAAGTGAG
AGTGTCAGCGT -> GTGTCAGCGTG
AGTTCTCTCGA -> GTTCTCTCGAA
ATAAACAACCG -> TAAACAACCGA
ATAAACGCTTC -> TAAACGCTTCC
ATAACGGCACT -> TAACGGCACTG
ATAACTATCGC -> TAACTATCGCA
ATAAGGTTACG -> TAAGGTTACGC
ATAATCATCCG -> TAATCATCCGC
ATAATTTGGCA -> TAATTTGGCAC
ATACATATCCG -> TACATATCCGT
ATACGACAGAG -> TACGACAGAGA
ATACGATGCGA -> TACGATGCGAT
ATACGCCTCCT -> TACGCCTCCTT
ATACGCGTGGC -> TACGCGTGGCC
ATACTGGTGCC -> TACTGGTGCCT
ATAGACACCCG -> TAGACACCCGT
ATAGACGTGCT -> TAGACGTGCTA
ATAGATAACTA -> TAGATAACTAT
ATAGATGCATT -> TAGATGCATTT
ATAGATGGGAT -> TAGATGGGATG
ATAGCACAGGT -> TAGCACAGGTC
ATAGCATTCCA -> TAGCATTCCAG
ATAGCGAGACC -> TAGCGAGACCC
ATAGCTGCCCG -> TAGCTGCCCGC
ATAGCTTTACG -> TAGCTTTACGA
ATAGGCGGCCT -> TAGGCGGCCTC
ATAGGGGTGCC -> TAGGGGTGCCA
ATAGGTTTACA -> TAGGTTTACAG
ATAGTATGAGA -> TAGTATGAGAC
ATAGTATGCAG -> TAGTATGCAGG
ATATACGACAG -> TATACGACAGA
ATATACGCGTG -> TATACGCGTGG
ATATAGATGGG -> TATAGATGGGA
ATATAGTATGA -> TATAGTATGAG
ATATAGTATGC -> TATAGTATGCA
ATATCCGTGGA -> TATCCGTGGAT
ATATGACCCGC -> TATGACCCGCT
ATATTCTTGTT -> TATTCTTGTTC
ATATTGTAGCG -> TATTGTAGCGT
ATCAACTTTCT -> TCAACTTTCTG
ATCACACCGAG -> TCACACCGAGA
ATCACTATCAC -> TCACTATCACA
ATCAGACCGGT -> TCAGACCGGTT
ATCATAGCTTT -> TCATAGCTTTA
ATCATCCGCAC -> TCATCCGCACT
ATCATCGAACG -> TCATCGAACGG
ATCATTCAACT -> TCATTCAACTT
ATCCAGACTAA -> TCCAGACTAAG
ATCCAGATAAA -> TCCAGATAAAC
ATCCCTAATCA -> TCCCTAATCAT
ATCCGCACTGC -> TCCGCACTGCA
ATCCGCCGACA -> TCCGCCGACAT
ATCCGCCTTAT -> TCCGCCTTATG
ATCCGTGGATC -> TCCGTGGATCA
ATCGAAACGAA -> TCGAAACGAAA
ATCGAACGGCC -> TCGAACGGCCT
ATCGAGCGAGC -> TCGAGCGAGCG
ATCGATGATTG -> TCGATGATTGT
ATCGCAGCCAG -> TCGCAGCCAGC
ATCGGGACGGA -> TCGGGACGGAA
ATCGGTATTGT -> TCGGTATTGTC
ATCGGTCGTGA -> TCGGTCGTGAG
ATCGTGCGTAG -> TCGTGCGTAGG
ATCTAAGGGAC -> TCTAAGGGACT
ATCTACGGCTG -> TCTACGGCTGT
ATCTCCCTACG -> TCTCCCTACGA
ATCTGGAGAAA -> TCTGGAGAAAT
ATCTTGACGTA -> TCTTGACGTAT
ATGAATGCGTC -> TGAATGCGTCT
ATGACACCGTT -> TGACACCGTTG
ATGACCCGCTC -> TGACCCGCTCC
ATGACCCTTGC -> TGACCCTTGCT
ATGAGACACAC -> TGAGACACACG
ATGATTGTGAC -> TGATTGTGACA
ATGCACACTAA -> TGCACACTAAC
ATGCAGGCGGA -> TGCAGGCGGAA
ATGCATTTCGT -> TGCATTTCGTG
ATGCCCAATTG -> TGCCCAATTGC
ATGCGACAAAT -> TGCGACAAATC
ATGCGATAATC -> TGCGATAATCA
ATGCGCTTAAT -> TGCGCTTAATC
ATGCGTCTGCC -> TGCGTCTGCCC
ATGCTCAGGGC -> TGCTCAGGGCT
ATGGAGTTCTC -> TGGAGTTCTCT
ATGGGATGCAC -> TGGGATGCACA
ATGGGCTGTTT -> TGGGCTGTTTG
ATGGGTCGAAA -> TGGGTCGAAAC
ATGGGTTTCGC -> TGGGTTTCGCC
ATGGTATGTCG -> TGGTATGTCGG
ATGGTGGCTCA -> TGGTGGCTCAT
ATGGTGTACCC -> TGGTGTACCCA
ATGTATGCGCT -> TGTATGCGCTT
ATGTCGGCATG -> TGTCGGCATGC
ATGTGCCACTA -> TGTGCCACTAT
ATGTGTGCGAG -> TGTGTGCGAGG
ATTAAACCCCT -> TTAAACCCCTA
ATTAAATCGAG -> TTAAATCGAGC
ATTAGGGCATA -> TTAGGGCATAC
ATTCAACTTTC -> TTCAACTTTCC
ATTCACCCGCT -> TTCACCCGCTT
ATTCCAGTGGT -> TTCCAGTGGTT
ATTCCCTGGGT -> TTCCCTGGGTG
ATTCTTGTTCA -> TTCTTGTTCAA
ATTCTTTCACA -> TTCTTTCACAA
ATTGCATTGGA -> TTGCATTGGAC
ATTGCGGCTAG -> TTGCGGCTAGA
ATTGCTGCCCT -> TTGCTGCCCTA
ATTGGACTCGG -> TTGGACTCGGC
ATTGGGAAACG -> TTGGGAAACGG
ATTGTAGCGTT -> TTGTAGCGTTC
ATTGTCTCCAA -> TTGTCTCCAAC
ATTGTGACACT -> TTGTGACACTC
ATTTAGTGGAG -> TTTAGTGGAGA
ATTTCGCTTGC -> TTTCGCTTGCT
ATTTCGTGCAA -> TTTCGTGCAAG
ATTTCTTGAGC -> TTTCTTGAGCG
ATTTGACGTAT -> TTTGACGTATT
ATTTGATATAG -> TTTGATATAGT
ATTTGGCACAC -> TTTGGCACACA
ATTTGGGCTAT -> TTTGGGCTATG
ATTTTATAGCA -> TTTTATAGCAT
ATTTTCCGCAC -> TTTTCCGCACT
ATTTTCGGTAA -> TTTTCGGTAAT
CAAAATTCTTT -> AAAATTCTTTC
CAAACAATGGT -> AAACAATGGTG
CAAACATAAAC -> AAACATAAACA
CAAACGCGGAG -> AAACGCGGAGT
CAAAGCGGCAG -> AAAGCGGCAGC
CAAAGGACACC -> AAAGGACACCC
CAAATAGCTGC -> AAATAGCTGCC
CAAATCCAGAT -> AAATCCAGATA
CAAATCGGTCG -> AAATCGGTCGT
CAACACGATCA -> AACACGATCAT
CAACCATCGTG -> AACCATCGTGC
CAACCGAATGG -> AACCGAATGGG
CAACGAGGATA -> AACGAGGATAT
CAACGTCTGTT -> AACGTCTGTTA
CAACGTGTCCA -> AACGTGTCCAG
CAACTCCTTGC -> AACTCCTTGCG
CAACTTTCCCT -> AACTTTCCCTG
CAACTTTCTGT -> AACTTTCTGTC
CAAGGCAGCAA -> AAGGCAGCAAA
CAAGGGAAGTC -> AAGGGAAGTCG
CAAGGTCGCAA -> AAGGTCGCAAA
CAAGTCATTAA -> AAGTCATTAAA
CAAGTGCTTCC -> AAGTGCTTCCC
CAAGTGTAAGT -> AAGTGTAAGTG
CAATATACGAC -> AATATACGACA
CAATCTTGACG -> AATCTTGACGT
CAATGGGTTTC -> AATGGGTTTCG
CAATGGTGGCT -> AATGGTGGCTC
CAATTGCGGCT -> AATTGCGGCTA
CAATTTTCCGC -> AATTTTCCGCA
CAATTTTCGGT -> AATTTTCGGTA
CACAAAGGACA -> ACAAAGGACAC
CACAAATAGCT -> ACAAATAGCTG
CACAAGTCATT -> ACAAGTCATTA
CACAATCTTGA -> ACAATCTTGAC
CACACAAGTCA -> ACACAAGTCAT
CACACAATCTT -> ACACAATCTTG
CACACCGAGAC -> ACACCGAGACA
CACACGGTGCA -> ACACGGTGCAA
CACACTAACAT -> ACACTAACATA
CACAGAGTCTG -> ACAGAGTCTGT
CACAGGTCGTG -> ACAGGTCGTGG
CACATATACGC -> ACATATACGCG
CACATGAATGC -> ACATGAATGCG
CACCCAGGTGC -> ACCCAGGTGCG
CACCCCACGAC -> ACCCCACGACG
CACCCGCTTGC -> ACCCGCTTGCG
CACCCGTATAG -> ACCCGTATAGA
CACCGAATGAC -> ACCGAATGACA
CACCGAGACAC -> ACCGAGACACG
CACCGATCCCT -> ACCGATCCCTA
CACCGCAGCGG -> ACCGCAGCGGA
CACCGTTGTAC -> ACCGTTGTACT
CACCTTTTTGG -> ACCTTTTTGGC
CACGAAAGAAG -> ACGAAAGAAGC
CACGAAGCTAG -> ACGAAGCTAGA
CACGACGACAC -> ACGACGACACT
CACGATCATCG -> ACGATCATCGA
CACGGTGCAAT -> ACGGTGCAATG
CACTAACATAC -> ACTAACATACG
CACTAACGAGC -> ACTAACGAGCA
CACTACATCCA -> ACTACATCCAG
CACTACCAGAT -> ACTACCAGATT
CACTATAGCGA -> ACTATAGCGAG
CACTATCACAC -> ACTATCACACC
CACTCAGCGGT -> ACTCAGCGGTT
CACTCGCGCTT -> ACTCGCGCTTG
CACTCTTGGGG -> ACTCTTGGGGG
CACTGATACTG -> ACTGATACTGG
CACTGCACCCA -> ACTGCACCCAG
CACTGGATCAG -> ACTGGATCAGA
CACTTCCATCG -> ACTTCCATCGA
CACTTCTGCCT -> ACTTCTGCCTG
CAGAACTCTAA -> AGAACTCTAAC
CAGACAAGTGT -> AGACAAGTGTA
CAGACCGGTTC -> AGACCGGTTCA
CAGACGTTCCT -> AGACGTTCCTC
CAGACTAAGTG -> AGACTAAGTGC
CAGAGACACAT -> AGAGACACATG
CAGAGTCTGTA -> AGAGTCTGTAC
CAGATAAACGC -> AGATAAACGCT
CAGATTGCTGC -> AGATTGCTGCC
CAGATTTCGCT -> AGATTTCGCTT
CAGCAAAGCGG -> AGCAAAGCGGC
CAGCATATTCT -> AGCATATTCTT
CAGCATCGGGA -> AGCATCGGGAC
CAGCCAGCATC -> AGCCAGCATCG
CAGCCCTAGCA -> AGCCCTAGCAG
CAGCCCTGTCT -> AGCCCTGTCTA
CAGCGGACCTC -> AGCGGACCTCT
CAGCGGTTTCT -> AGCGGTTTCTG
CAGCGTGGATA -> AGCGTGGATAC
CAGGACCGGCT -> AGGACCGGCTC
CAGGATATTGT -> AGGATATTGTA
CAGGCAACACG -> AGGCAACACGA
CAGGCGGAAGC -> AGGCGGAAGCG
CAGGCTCATTT -> AGGCTCATTTG
CAGGGCTTATA -> AGGGCTTATAG
CAGGTCGGCCC -> AGGTCGGCCCT
CAGGTCGTGGA -> AGGTCGTGGAT
CAGGTGCGCAC -> AGGTGCGCACG
CAGGTTCGCGA -> AGGTTCGCGAG
CAGTCAATTTT -> AGTCAATTTTC
CAGTGGTTCAT -> AGTGGTTCATT
CATAAACAACC -> ATAAACAACCG
CATACGATGCG -> ATACGATGCGA
CATACGCCTCC -> ATACGCCTCCT
CATAGACACCC -> ATAGACACCCG
CATAGCACAGG -> ATAGCACAGGT
CATAGCTTTAC -> ATAGCTTTACG
CATATACGCGT -> ATATACGCGTG
CATATCCGTGG -> ATATCCGTGGA
CATATTCTTGT -> ATATTCTTGTT
CATCACTATCA -> ATCACTATCAC
CATCCAGACTA -> ATCCAGACTAA
CATCCGCACTG -> ATCCGCACTGC
CATCGAAACGA -> ATCGAAACGAA
CATCGAACGGC -> ATCGAACGGCC
CATCGGGACGG -> ATCGGGACGGA
CATCGTGCGTA -> ATCGTGCGTAG
CATCTGGAGAA -> ATCTGGAGAAA
CATGAATGCGT -> ATGAATGCGTC
CATGCGACAAA -> ATGCGACAAAT
CATGCTCAGGG -> ATGCTCAGGGC
CATGTGCCACT -> ATGTGCCACTA
CATTAAATCGA -> ATTAAATCGAG
CATTCAACTTT -> ATTCAACTTTC
CATTCCAGTGG -> ATTCCAGTGGT
CATTCCCTGGG -> ATTCCCTGGGT
CATTGGACTCG -> ATTGGACTCGG
CATTTCGTGCA -> ATTTCGTGCAA
CATTTGACGTA -> ATTTGACGTAT
CATTTGATATA -> ATTTGATATAG
CATTTGGGCTA -> ATTTGGGCTAT
CCAAACAATGG -> CAAACAATGGT
CCAAACATAAA -> CAAACATAAAC
CCAACCATCGT -> CAACCATCGTG
CCAACTCCTTG -> CAACTCCTTGC
CCAAGGCAGCA -> CAAGGCAGCAA
CCAATTGCGGC -> CAATTGCGGCT
CCAATTTTCCG -> CAATTTTCCGC
CCACAAAGGAC -> CACAAAGGACA
CCACCGATCCC -> CACCGATCCCT
CCACCTTTTTG -> CACCTTTTTGG
CCACGACGACA -> CACGACGACAC
CCACTATAGCG -> CACTATAGCGA
CCACTTCTGCC -> CACTTCTGCCT
CCAGACGTTCC -> CAGACGTTCCT
CCAGACTAAGT -> CAGACTAAGTG
CCAGATAAACG -> CAGATAAACGC
CCAGATTTCGC -> CAGATTTCGCT
CCAGCATCGGG -> CAGCATCGGGA
CCAGCCCTGTC -> CAGCCCTGTCT
CCAGGTCGGCC -> CAGGTCGGCCC
CCAGGTGCGCA -> CAGGTGCGCAC
CCAGTGGTTCA -> CAGTGGTTCAT
CCATCGAAACG -> CATCGAAACGA
CCATCGTGCGT -> CATCGTGCGTA
CCATGTGCCAC -> CATGTGCCACT
CCATTTGACGT -> CATTTGACGTA
CCCAAACAATG -> CCAAACAATGG
CCCAATTGCGG -> CCAATTGCGGC
CCCACAAAGGA -> CCACAAAGGAC
CCCACCTTTTT -> CCACCTTTTTG
CCCACGACGAC -> CCACGACGACA
CCCAGGTGCGC -> CCAGGTGCGCA
CCCATGTGCCA -> CCATGTGCCAC
CCCCACGACGA -> CCCACGACGAC
CCCCCGGTCGA -> CCCCGGTCGAG
CCCCGGTCGAG -> CCCGGTCGAGC
CCCCTAGAGCG -> CCCTAGAGCGG
CCCGATGGTGT -> CCGATGGTGTA
CCCGCGATTTT -> CCGCGATTTTA
CCCGCTCCAGG -> CCGCTCCAGGT
CCCGCTTGCGC -> CCGCTTGCGCC
CCCGGTCGAGC -> CCGGTCGAGCC
CCCGGTTCGAA -> CCGGTTCGAAA
CCCGTATAGAC -> CCGTATAGACG
CCCGTGATAGG -> CCGTGATAGGT
CCCTAATCATT -> CCTAATCATTC
CCCTACGAACC -> CCTACGAACCG
CCCTAGAGCGG -> CCTAGAGCGGA
CCCTAGCAGGC -> CCTAGCAGGCT
CCCTAGGCCGC -> CCTAGGCCGCG
CCCTCGCACTT -> CCTCGCACTTC
CCCTCTGGTAT -> CCTCTGGTATC
CCCTGGGTGCG -> CCTGGGTGCGT
CCCTGGTGGCT -> CCTGGTGGCTC
CCCTGTCTAAC -> CCTGTCTAACC
CCCTTAAAGGG -> CCTTAAAGGGG
CCCTTCGGTCG -> CCTTCGGTCGA
CCCTTGCTCCC -> CCTTGCTCCCG
CCGAATGACAC -> CGAATGACACC
CCGAATGGGTC -> CGAATGGGTCG
CCGACATAGCA -> CGACATAGCAC
CCGAGACACGA -> CGAGACACGAA
CCGATCCCTAA -> CGATCCCTAAT
CCGATGGTGTA -> CGATGGTGTAC
CCGCAAACGCG -> CGCAAACGCGG
CCGCACTACAT -> CGCACTACATC
CCGCACTGCAC -> CGCACTGCACC
CCGCAGCGGAC -> CGCAGCGGACC
CCGCCCAAACA -> CGCCCAAACAA
CCGCCGACATA -> CGCCGACATAG
CCGCCTTATGT -> CGCCTTATGTG
CCGCGAACCCC -> CGCGAACCCCC
CCGCGATTTTA -> CGCGATTTTAT
CCGCTCCAGGT -> CGCTCCAGGTC
CCGCTTGCGCC -> CGCTTGCGCCA
CCGGCTCCTCG -> CGGCTCCTCGA
CCGGTACGCTA -> CGGTACGCTAG
CCGGTCGAGCC -> CGGTCGAGCCT
CCGGTTCACTC -> CGGTTCACTCA
CCGGTTCGAAA -> CGGTTCGAAAT
CCGTACAGGTT -> CGTACAGGTTC
CCGTATAGACG -> CGTATAGACGT
CCGTGATAGGT -> CGTGATAGGTT
CCGTGGATCAT -> CGTGGATCATA
CCGTGGGGTGT -> CGTGGGGTGTA
CCGTTGAGTGT -> CGTTGAGTGTC
CCGTTGTACTG -> CGTTGTACTGG
CCGTTTATCAA -> CGTTTATCAAC
CCTAACGACGA -> CTAACGACGAC
CCTAATCATTC -> CTAATCATTCA
CCTACGAACCG -> CTACGAACCGC
CCTAGAGCGGA -> CTAGAGCGGAC
CCTAGCAGGCT -> CTAGCAGGCTC
CCTAGGCCGCG -> CTAGGCCGCGA
CCTATATGACC -> CTATATGACCC
CCTATCTACGG -> CTATCTACGGC
CCTCACAGAGT -> CTCACAGAGTC
CCTCAGCACTG -> CTCAGCACTGA
CCTCCTTCCAA -> CTCCTTCCAAT
CCTCGAATCTC -> CTCGAATCTCC
CCTCGCACTTC -> CTCGCACTTCC
CCTCTGGTATC -> CTCTGGTATCT
CCTCTTGCCGT -> CTCTTGCCGTG
CCTCTTTGGCG -> CTCTTTGGCGC
CCTGCTAATGC -> CTGCTAATGCC
CCTGGGTGCGT -> CTGGGTGCGTG
CCTGGTGGCTC -> CTGGTGGCTCA
CCTGTACAACG -> CTGTACAACGA
CCTGTCTAACC -> CTGTCTAACCA
CCTTAAAGGGG -> CTTAAAGGGGG
CCTTATGTGTG -> CTTATGTGTGC
CCTTCCAATTT -> CTTCCAATTTT
CCTTCGGTCGA -> CTTCGGTCGAA
CCTTGCGAAAG -> CTTGCGAAAGG
CCTTGCTCCCG -> CTTGCTCCCGG
CCTTTTCTAAC -> CTTTTCTAACG
CCTTTTTGGCA -> CTTTTTGGCAT
CGAAACACCGA -> GAAACACCGAA
CGAAACCGCAA -> GAAACCGCAAA
CGAAACGAAAT -> GAAACGAAATT
CGAAAGAAGCC -> GAAAGAAGCCC
CGAAAGGCAGG -> GAAAGGCAGGA
CGAAATAACGG -> GAAATAACGGC
CGAAATTGCAT -> GAAATTGCATT
CGAAATTGGGA -> GAAATTGGGAA
CGAACCCCCGG -> GAACCCCCGGT
CGAACCGCCCA -> GAACCGCCCAA
CGAACGGCCTA -> GAACGGCCTAT
CGAACGTCAGG -> GAACGTCAGGC
CGAAGCGTTAC -> GAAGCGTTACT
CGAAGCTAGAC -> GAAGCTAGACT
CGAATCTCCCT -> GAATCTCCCTA
CGAATGACACC -> GAATGACACCG
CGAATGGGTCG -> GAATGGGTCGA
CGACAAATCCA -> GACAAATCCAG
CGACACTAACG -> GACACTAACGA
CGACAGAGACA -> GACAGAGACAC
CGACAGATTGC -> GACAGATTGCT
CGACATAGCAC -> GACATAGCACA
CGACGACACTA -> GACGACACTAA
CGACGACAGAT -> GACGACAGATT
CGACTACCAAG -> GACTACCAAGG
CGAGACACGAA -> GAGACACGAAA
CGAGACCCTCT -> GAGACCCTCTG
CGAGAGGAGCG -> GAGAGGAGCGT
CGAGAGTAAAG -> GAGAGTAAAGG
CGAGCAGTCAA -> GAGCAGTCAAT
CGAGCCTATCT -> GAGCCTATCTA
CGAGCGAGCGC -> GAGCGAGCGCG
CGAGCGCGTGC -> GAGCGCGTGCT
CGAGGATATAG -> GAGGATATAGT
CGAGGGTCATC -> GAGGGTCATCA
CGAGTACCGTT -> GAGTACCGTTG
CGAGTCGCTTT -> GAGTCGCTTTC
CGATAATCATC -> GATAATCATCC
CGATATAGATG -> GATATAGATGG
CGATCATCGAA -> GATCATCGAAC
CGATCCCTAAT -> GATCCCTAATC
CGATCCGCCGA -> GATCCGCCGAC
CGATGATTGTG -> GATGATTGTGA
CGATGCGATAA -> GATGCGATAAT
CGATGGTGTAC -> GATGGTGTACC
CGATTTTATAG -> GATTTTATAGC
CGCAAAATTCT -> GCAAAATTCTT
CGCAAACGCGG -> GCAAACGCGGA
CGCAAATCGGT -> GCAAATCGGTC
CGCAAGGGAAG -> GCAAGGGAAGT
CGCACGAAGCT -> GCACGAAGCTA
CGCACTACATC -> GCACTACATCC
CGCACTGCACC -> GCACTGCACCC
CGCACTTCCAT -> GCACTTCCATC
CGCAGAACTCT -> GCAGAACTCTA
CGCAGCCAGCA -> GCAGCCAGCAT
CGCAGCGGACC -> GCAGCGGACCT
CGCCAACCATC -> GCCAACCATCG
CGCCATTTGAC -> GCCATTTGACG
CGCCCAAACAA -> GCCCAAACAAT
CGCCGACATAG -> GCCGACATAGC
CGCCTCCTTCC -> GCCTCCTTCCA
CGCCTTATGTG -> GCCTTATGTGT
CGCGAACCCCC -> GCGAACCCCCG
CGCGAGAGGAG -> GCGAGAGGAGC
CGCGATTTTAT -> GCGATTTTATA
CGCGCGGGGGA -> GCGCGGGGGAT
CGCGCTTGTCG -> GCGCTTGTCGA
CGCGGAGTCTC -> GCGGAGTCTCT
CGCGGGGGATT -> GCGGGGGATTC
CGCGTGCTAGC -> GCGTGCTAGCA
CGCGTGGCCGT -> GCGTGGCCGTA
CGCTAGGACTA -> GCTAGGACTAC
CGCTCCAGGTC -> GCTCCAGGTCG
CGCTCTTTCAA -> GCTCTTTCAAG
CGCTTAATCGG -> GCTTAATCGGT
CGCTTCCTTTT -> GCTTCCTTTTC
CGCTTGCGCCA -> GCTTGCGCCAA
CGCTTGCTCAT -> GCTTGCTCATC
CGCTTGTCGAT -> GCTTGTCGATA
CGCTTTCCGGT -> GCTTTCCGGTA
CGGAACGAGTA -> GGAACGAGTAC
CGGAAGCGAAG -> GGAAGCGAAGC
CGGACCTCTTG -> GGACCTCTTGC
CGGACTAGAAT -> GGACTAGAATC
CGGAGTCTCTC -> GGAGTCTCTCC
CGGCACTGATA -> GGCACTGATAC
CGGCAGCCCTA -> GGCAGCCCTAG
CGGCATGCGAC -> GGCATGCGACA
CGGCCCTTCGG -> GGCCCTTCGGT
CGGCCTATATG -> GGCCTATATGA
CGGCCTCAGCA -> GGCCTCAGCAC
CGGCTAGATAG -> GGCTAGATAGA
CGGCTCCTCGA -> GGCTCCTCGAA
CGGCTGCGCAG -> GGCTGCGCAGA
CGGCTGTTAAT -> GGCTGTTAATA
CGGGACGGAAC -> GGGACGGAACG
CGGGCGAGAGT -> GGGCGAGAGTA
CGGGGGATTCA -> GGGGGATTCAC
CGGTAATGGGC -> GGTAATGGGCT
CGGTACGCTAG -> GGTACGCTAGG
CGGTAGATTAA -> GGTAGATTAAA
CGGTATTGTCT -> GGTATTGTCTC
CGGTCGAAATT -> GGTCGAAATTG
CGGTCGAGCCT -> GGTCGAGCCTA
CGGTCGTGAGT -> GGTCGTGAGTA
CGGTGCAATGG -> GGTGCAATGGG
CGGTTCACTCA -> GGTTCACTCAG
CGGTTCGAAAT -> GGTTCGAAATA
CGGTTTCTGAT -> GGTTTCTGATA
CGTACAGGTTC -> GTACAGGTTCG
CGTAGGAGCGC -> GTAGGAGCGCA
CGTATAGACGT -> GTATAGACGTG
CGTATGGAGTT -> GTATGGAGTTC
CGTATTTCTTG -> GTATTTCTTGA
CGTCAGGCAAC -> GTCAGGCAACA
CGTCCAGCCCT -> GTCCAGCCCTG
CGTCTCGTGTT -> GTCTCGTGTTG
CGTCTGCCCAT -> GTCTGCCCATG
CGTCTGTTAAC -> GTCTGTTAACA
CGTGAGTAGGC -> GTGAGTAGGCG
CGTGATAGGTT -> GTGATAGGTTT
CGTGCAAGTGC -> GTGCAAGTGCT
CGTGCGTAGGA -> GTGCGTAGGAG
CGTGCTAAGGG -> GTGCTAAGGGA
CGTGCTAGCAC -> GTGCTAGCACA
CGTGGATACAT -> GTGGATACATA
CGTGGATAGGC -> GTGGATAGGCG
CGTGGATCATA -> GTGGATCATAG
CGTGGCCGTAC -> GTGGCCGTACA
CGTGGGGTGTA -> GTGGGGTGTAC
CGTGGTAACAA -> GTGGTAACAAT
CGTGTAGGTTG -> GTGTAGGTTGA
CGTGTCCAGAC -> GTGTCCAGACG
CGTGTTGAGGC -> GTGTTGAGGCA
CGTTACTTTGG -> GTTACTTTGGG
CGTTCCCTCGC -> GTTCCCTCGCA
CGTTCCTCACA -> GTTCCTCACAG
CGTTGAGTGTC -> GTTGAGTGTCA
CGTTGGCCGTT -> GTTGGCCGTTT
CGTTGTACTGG -> GTTGTACTGGT
CGTTTATCAAC -> GTTTATCAACT
CTAACACCGCA -> TAACACCGCAG
CTAACATACGA -> TAACATACGAT
CTAACCACCGA -> TAACCACCGAT
CTAACGACGAC -> TAACGACGACA
CTAACGAGCAG -> TAACGAGCAGT
CTAACGTCTCG -> TAACGTCTCGT
CTAAGGGACTC -> TAAGGGACTCG
CTAAGGGATTT -> TAAGGGATTTA
CTAAGTGCTAG -> TAAGTGCTAGT
CTAATCATTCA -> TAATCATTCAA
CTAATGCCCAA -> TAATGCCCAAT
CTACATCCAGA -> TACATCCAGAC
CTACCAAGGCA -> TACCAAGGCAG
CTACCAGATTT -> TACCAGATTTC
CTACCCTTAAA -> TACCCTTAAAG
CTACGAACCGC -> TACGAACCGCC
CTACGGCTGTT -> TACGGCTGTTA
CTAGAATCGAT -> TAGAATCGATG
CTAGACTGGAA -> TAGACTGGAAT
CTAGAGCGGAC -> TAGAGCGGACT
CTAGATAGATA -> TAGATAGATAA
CTAGCACACAA -> TAGCACACAAT
CTAGCAGGCTC -> TAGCAGGCTCA
CTAGGACTACC -> TAGGACTACCC
CTAGGCCGCGA -> TAGGCCGCGAA
CTAGTACCTAA -> TAGTACCTAAC
CTAGTGACTTG -> TAGTGACTTGT
CTATAGCGAGA -> TATAGCGAGAC
CTATATGACCC -> TATATGACCCG
CTATCACACCG -> TATCACACCGA
CTATCGCAGCC -> TATCGCAGCCA
CTATCTACGGC -> TATCTACGGCT
CTATGTATGCG -> TATGTATGCGC
CTCAACGTGTC -> TCAACGTGTCC
CTCACAGAGTC -> TCACAGAGTCT
CTCAGCACTGA -> TCAGCACTGAT
CTCAGCGGTTT -> TCAGCGGTTTC
CTCAGGGCTTA -> TCAGGGCTTAT
CTCATCTGGAG -> TCATCTGGAGA
CTCATTTGATA -> TCATTTGATAT
CTCATTTGGGC -> TCATTTGGGCT
CTCCAACTCCT -> TCCAACTCCTT
CTCCACTTCTG -> TCCACTTCTGC
CTCCAGGTCGG -> TCCAGGTCGGC
CTCCCGGTTCG -> TCCCGGTTCGA
CTCCCTACGAA -> TCCCTACGAAC
CTCCTCGAATC -> TCCTCGAATCT
CTCCTCTTTGG -> TCCTCTTTGGC
CTCCTTCCAAT -> TCCTTCCAATT
CTCCTTGCGAA -> TCCTTGCGAAA
CTCGAACGTCA -> TCGAACGTCAG
CTCGAATCTCC -> TCGAATCTCCC
CTCGCACTTCC -> TCGCACTTCCA
CTCGCGCTTGT -> TCGCGCTTGTC
CTCGGCTGCGC -> TCGGCTGCGCA
CTCGTCCAGCC -> TCGTCCAGCCC
CTCGTGTTGAG -> TCGTGTTGAGG
CTCTAACACCG -> TCTAACACCGC
CTCTCCACTTC -> TCTCCACTTCT
CTCTCGAACGT -> TCTCGAACGTC
CTCTGGTATCT -> TCTGGTATCTA
CTCTTGCCGTG -> TCTTGCCGTGG
CTCTTGGGGGG -> TCTTGGGGGGG
CTCTTTCAAGG -> TCTTTCAAGGT
CTCTTTGGCGC -> TCTTTGGCGCT
CTGAACTGACG -> TGAACTGACGT
CTGACGTGTAG -> TGACGTGTAGG
CTGATACTGGT -> TGATACTGGTG
CTGATAGGGGT -> TGATAGGGGTG
CTGCACCCAGG -> TGCACCCAGGT
CTGCCCATGTG -> TGCCCATGTGC
CTGCCCGCGAT -> TGCCCGCGATT
CTGCCCTAGGC -> TGCCCTAGGCC
CTGCCTGCTAA -> TGCCTGCTAAT
CTGCGCAGAAC -> TGCGCAGAACT
CTGCTAATGCC -> TGCTAATGCCC
CTGCTTTTCTA -> TGCTTTTCTAG
CTGGAATGACC -> TGGAATGACCC
CTGGAGAAATC -> TGGAGAAATCC
CTGGATCAGAC -> TGGATCAGACC
CTGGGTGCGTG -> TGGGTGCGTGG
CTGGTATCTAA -> TGGTATCTAAG
CTGGTGCCTGT -> TGGTGCCTGTA
CTGGTGCGGTA -> TGGTGCGGTAG
CTGGTGGCTCA -> TGGTGGCTCAA
CTGTACAACGA -> TGTACAACGAG
CTGTACTGAAC -> TGTACTGAACT
CTGTCACTACC -> TGTCACTACCA
CTGTCTAACCA -> TGTCTAACCAC
CTGTTAACATG -> TGTTAACATGC
CTGTTAATAAT -> TGTTAATAATT
CTGTTTGCACA -> TGTTTGCACAT
CTTAAAGGGGG -> TTAAAGGGGGC
CTTAATCGGTA -> TTAATCGGTAT
CTTATAGATGC -> TTATAGATGCA
CTTATGTGTGC -> TTATGTGTGCG
CTTCCAATTTT -> TTCCAATTTTC
CTTCCATCGAA -> TTCCATCGAAA
CTTCCCACAAA -> TTCCCACAAAG
CTTCCTTTTCT -> TTCCTTTTCTA
CTTCGGTCGAA -> TTCGGTCGAAA
CTTCTGCCTGC -> TTCTGCCTGCT
CTTGACGTATG -> TTGACGTATGG
CTTGAGCGCGC -> TTGAGCGCGCG
CTTGCCGTGGG -> TTGCCGTGGGG
CTTGCGAAAGG -> TTGCGAAAGGC
CTTGCGCCAAC -> TTGCGCCAACC
CTTGCTCATCT -> TTGCTCATCTG
CTTGCTCCCGG -> TTGCTCCCGGT
CTTGGGGGGGG -> TTGGGGGGGGA
CTTGTCGATAT -> TTGTCGATATA
CTTGTCTCCTC -> TTGTCTCCTCT
CTTGTTCAACG -> TTGTTCAACGT
CTTTACGAGTC -> TTTACGAGTCG
CTTTCAAGGTC -> TTTCAAGGTCG
CTTTCACAAAT -> TTTCACAAATA
CTTTCCCTGGT -> TTTCCCTGGTG
CTTTCCGGTAC -> TTTCCGGTACG
CTTTCTGTCAC -> TTTCTGTCACT
CTTTGGCGCTC -> TTTGGCGCTCT
CTTTGGGCGAT -> TTTGGGCGATC
CTTTTCTAACG -> TTTTCTAACGT
CTTTTCTAGTG -> TTTTCTAGTGA
CTTTTTGGCAT -> TTTTTGGCATA
GAAACACCGAA -> AAACACCGAAT
GAAACCGCAAA -> AAACCGCAAAC
GAAACGAAATT -> AAACGAAATTG
GAAACGGGCGA -> AAACGGGCGAG
GAAAGAAGCCC -> AAAGAAGCCCG
GAAAGGCAGGA -> AAAGGCAGGAT
GAAATAACGGC -> AAATAACGGCA
GAAATCCGCCT -> AAATCCGCCTT
GAAATTGCATT -> AAATTGCATTG
GAAATTGGGAA -> AAATTGGGAAA
GAACCCCCGGT -> AACCCCCGGTC
GAACCGCCCAA -> AACCGCCCAAA
GAACGAGTACC -> AACGAGTACCG
GAACGGCCTAT -> AACGGCCTATA
GAACGTCAGGC -> AACGTCAGGCA
GAACTCTAACA -> AACTCTAACAC
GAACTGACGTG -> AACTGACGTGT
GAAGCCCGTGA -> AAGCCCGTGAT
GAAGCGAAGCG -> AAGCGAAGCGT
GAAGCGTTACT -> AAGCGTTACTT
GAAGCTAGACT -> AAGCTAGACTG
GAAGTCGACTA -> AAGTCGACTAC
GAATCGATGAT -> AATCGATGATT
GAATCTCCCTA -> AATCTCCCTAC
GAATGACACCG -> AATGACACCGT
GAATGACCCTT -> AATGACCCTTG
GAATGCGTCTG -> AATGCGTCTGC
GAATGGGTCGA -> AATGGGTCGAA
GACAAATCCAG -> ACAAATCCAGA
GACAAGTGTAA -> ACAAGTGTAAG
GACACACGGTG -> ACACACGGTGC
GACACATGAAT -> ACACATGAATG
GACACCCCACG -> ACACCCCACGA
GACACCCGTAT -> ACACCCGTATA
GACACCGTTGT -> ACACCGTTGTA
GACACGAAAGA -> ACACGAAAGAA
GACACTAACGA -> ACACTAACGAG
GACACTCGCGC -> ACACTCGCGCT
GACAGAGACAC -> ACAGAGACACA
GACAGATTGCT -> ACAGATTGCTG
GACAGCATATT -> ACAGCATATTC
GACATAGCACA -> ACATAGCACAG
GACCCGCTCCA -> ACCCGCTCCAG
GACCCTCTGGT -> ACCCTCTGGTA
GACCCTTGCTC -> ACCCTTGCTCC
GACCGGCTCCT -> ACCGGCTCCTC
GACCGGTTCAC -> ACCGGTTCACT
GACCTCTTGCC -> ACCTCTTGCCG
GACGACACTAA -> ACGACACTAAC
GACGACAGATT -> ACGACAGATTG
GACGGAACGAG -> ACGGAACGAGT
GACGTATGGAG -> ACGTATGGAGT
GACGTATTTCT -> ACGTATTTCTT
GACGTGCTAAG -> ACGTGCTAAGG
GACGTGTAGGT -> ACGTGTAGGTT
GACGTTCCTCA -> ACGTTCCTCAC
GACTAAGTGCT -> ACTAAGTGCTA
GACTACCAAGG -> ACTACCAAGGC
GACTACCCTTA -> ACTACCCTTAA
GACTAGAATCG -> ACTAGAATCGA
GACTCGGCTGC -> ACTCGGCTGCG
GACTCGTCCAG -> ACTCGTCCAGC
GACTGGAATGA -> ACTGGAATGAC
GACTTGTCTCC -> ACTTGTCTCCT
GAGAAATCCGC -> AGAAATCCGCC
GAGACACACGG -> AGACACACGGT
GAGACACATGA -> AGACACATGAA
GAGACACGAAA -> AGACACGAAAG
GAGACAGCATA -> AGACAGCATAT
GAGACCCTCTG -> AGACCCTCTGG
GAGAGGAGCGT -> AGAGGAGCGTT
GAGAGTAAAGG -> AGAGTAAAGGA
GAGCACTCTTG -> AGCACTCTTGG
GAGCAGTCAAT -> AGCAGTCAATT
GAGCCTATCTA -> AGCCTATCTAC
GAGCGAGCGCG -> AGCGAGCGCGT
GAGCGCAAGGG -> AGCGCAAGGGA
GAGCGCGCGGG -> AGCGCGCGGGG
GAGCGCGTGCT -> AGCGCGTGCTA
GAGCGGACTAG -> AGCGGACTAGA
GAGCGTTGGCC -> AGCGTTGGCCG
GAGGAGCGTTG -> AGGAGCGTTGG
GAGGATATAGT -> AGGATATAGTA
GAGGCACTGGA -> AGGCACTGGAT
GAGGGTCATCA -> AGGGTCATCAC
GAGTAAAGGAG -> AGTAAAGGAGT
GAGTACCGTTG -> AGTACCGTTGA
GAGTAGGCGAA -> AGTAGGCGAAA
GAGTCGCTTTC -> AGTCGCTTTCC
GAGTCTCTCCA -> AGTCTCTCCAC
GAGTCTGTACT -> AGTCTGTACTG
GAGTGCCCGAT -> AGTGCCCGATG
GAGTGTCAGCG -> AGTGTCAGCGT
GAGTTCTCTCG -> AGTTCTCTCGA
GATAAACGCTT -> ATAAACGCTTC
GATAACTATCG -> ATAACTATCGC
GATAATCATCC -> ATAATCATCCG
GATACATATCC -> ATACATATCCG
GATACTGGTGC -> ATACTGGTGCC
GATAGATAACT -> ATAGATAACTA
GATAGGCGGCC -> ATAGGCGGCCT
GATAGGGGTGC -> ATAGGGGTGCC
GATAGGTTTAC -> ATAGGTTTACA
GATATAGATGG -> ATATAGATGGG
GATATAGTATG -> ATATAGTATGA,ATATAGTATGC
GATATTGTAGC -> ATATTGTAGCG
GATCAGACCGG -> ATCAGACCGGT
GATCATAGCTT -> ATCATAGCTTT
GATCATCGAAC -> ATCATCGAACG
GATCCCTAATC -> ATCCCTAATCA
GATCCGCCGAC -> ATCCGCCGACA
GATGATTGTGA -> ATGATTGTGAC
GATGCACACTA -> ATGCACACTAA
GATGCATTTCG -> ATGCATTTCGT
GATGCGATAAT -> ATGCGATAATC
GATGGGATGCA -> ATGGGATGCAC
GATGGTATGTC -> ATGGTATGTCG
GATGGTGTACC -> ATGGTGTACCC
GATTAAACCCC -> ATTAAACCCCT
GATTAGGGCAT -> ATTAGGGCATA
GATTCACCCGC -> ATTCACCCGCT
GATTGCTGCCC -> ATTGCTGCCCT
GATTGTGACAC -> ATTGTGACACT
GATTTAGTGGA -> ATTTAGTGGAG
GATTTCGCTTG -> ATTTCGCTTGC
GATTTTATAGC -> ATTTTATAGCA
GCAAAATTCTT -> CAAAATTCTTT
GCAAACGCGGA -> CAAACGCGGAG
GCAAAGCGGCA -> CAAAGCGGCAG
GCAAATCGGTC -> CAAATCGGTCG
GCAACACGATC -> CAACACGATCA
GCAAGGGAAGT -> CAAGGGAAGTC
GCAAGTGCTTC -> CAAGTGCTTCC
GCAATGGGTTT -> CAATGGGTTTC
GCACACAAGTC -> CACACAAGTCA
GCACACAATCT -> CACACAATCTT
GCACACTAACA -> CACACTAACAT
GCACAGGTCGT -> CACAGGTCGTG
GCACATATACG -> CACATATACGC
GCACCCAGGTG -> CACCCAGGTGC
GCACGAAGCTA -> CACGAAGCTAG
GCACTACATCC -> CACTACATCCA
GCACTCTTGGG -> CACTCTTGGGG
GCACTGATACT -> CACTGATACTG
GCACTGCACCC -> CACTGCACCCA
GCACTGGATCA -> CACTGGATCAG
GCACTTCCATC -> CACTTCCATCG
GCAGAACTCTA -> CAGAACTCTAA
GCAGCAAAGCG -> CAGCAAAGCGG
GCAGCCAGCAT -> CAGCCAGCATC
GCAGCCCTAGC -> CAGCCCTAGCA
GCAGCGGACCT -> CAGCGGACCTC
GCAGGATATTG -> CAGGATATTGT
GCAGGCGGAAG -> CAGGCGGAAGC
GCAGGCTCATT -> CAGGCTCATTT
GCAGTCAATTT -> CAGTCAATTTT
GCATACGCCTC -> CATACGCCTCC
GCATAGACACC -> CATAGACACCC
GCATATTCTTG -> CATATTCTTGT
GCATCGGGACG -> CATCGGGACGG
GCATGCGACAA -> CATGCGACAAA
GCATTCCAGTG -> CATTCCAGTGG
GCATTGGACTC -> CATTGGACTCG
GCATTTCGTGC -> CATTTCGTGCA
GCCAAACATAA -> CCAAACATAAA
GCCAACCATCG -> CCAACCATCGT
GCCACTATAGC -> CCACTATAGCG
GCCAGCATCGG -> CCAGCATCGGG
GCCATTTGACG -> CCATTTGACGT
GCCCAAACAAT -> CCCAAACAATG
GCCCAATTGCG -> CCCAATTGCGG
GCCCATGTGCC -> CCCATGTGCCA
GCCCGATGGTG -> CCCGATGGTGT
GCCCGCGATTT -> CCCGCGATTTT
GCCCGTGATAG -> CCCGTGATAGG
GCCCTAGCAGG -> CCCTAGCAGGC
GCCCTAGGCCG -> CCCTAGGCCGC
GCCCTGTCTAA -> CCCTGTCTAAC
GCCCTTCGGTC -> CCCTTCGGTCG
GCCGACATAGC -> CCGACATAGCA
GCCGCGAACCC -> CCGCGAACCCC
GCCGTACAGGT -> CCGTACAGGTT
GCCGTGGGGTG -> CCGTGGGGTGT
GCCGTTTATCA -> CCGTTTATCAA
GCCTATATGAC -> CCTATATGACC
GCCTATCTACG -> CCTATCTACGG
GCCTCAGCACT -> CCTCAGCACTG
GCCTCCTTCCA -> CCTCCTTCCAA
GCCTGCTAATG -> CCTGCTAATGC
GCCTGTACAAC -> CCTGTACAACG
GCCTTATGTGT -> CCTTATGTGTG
GCGAAACACCG -> CGAAACACCGA
GCGAAAGGCAG -> CGAAAGGCAGG
GCGAACCCCCG -> CGAACCCCCGG
GCGAAGCGTTA -> CGAAGCGTTAC
GCGACAAATCC -> CGACAAATCCA
GCGAGACCCTC -> CGAGACCCTCT
GCGAGAGGAGC -> CGAGAGGAGCG
GCGAGAGTAAA -> CGAGAGTAAAG
GCGAGCGCGTG -> CGAGCGCGTGC
GCGAGGGTCAT -> CGAGGGTCATC
GCGATAATCAT -> CGATAATCATC
GCGATCCGCCG -> CGATCCGCCGA
GCGATTTTATA -> CGATTTTATAG
GCGCAAGGGAA -> CGCAAGGGAAG
GCGCACGAAGC -> CGCACGAAGCT
GCGCAGAACTC -> CGCAGAACTCT
GCGCCAACCAT -> CGCCAACCATC
GCGCGCGGGGG -> CGCGCGGGGGA
GCGCGGGGGAT -> CGCGGGGGATT
GCGCGTGCTAG -> CGCGTGCTAGC
GCGCTCTTTCA -> CGCTCTTTCAA
GCGCTTAATCG -> CGCTTAATCGG
GCGCTTGTCGA -> CGCTTGTCGAT
GCGGAAGCGAA -> CGGAAGCGAAG
GCGGACCTCTT -> CGGACCTCTTG
GCGGACTAGAA -> CGGACTAGAAT
GCGGAGTCTCT -> CGGAGTCTCTC
GCGGCAGCCCT -> CGGCAGCCCTA
GCGGCCTCAGC -> CGGCCTCAGCA
GCGGCTAGATA -> CGGCTAGATAG
GCGGGGGATTC -> CGGGGGATTCA
GCGGTAGATTA -> CGGTAGATTAA
GCGGTTTCTGA -> CGGTTTCTGAT
GCGTAGGAGCG -> CGTAGGAGCGC
GCGTCTGCCCA -> CGTCTGCCCAT
GCGTGCTAGCA -> CGTGCTAGCAC
GCGTGGATACA -> CGTGGATACAT
GCGTGGCCGTA -> CGTGGCCGTAC
GCGTGGTAACA -> CGTGGTAACAA
GCGTTACTTTG -> CGTTACTTTGG
GCGTTCCCTCG -> CGTTCCCTCGC
GCGTTGGCCGT -> CGTTGGCCGTT
GCTAAGGGATT -> CTAAGGGATTT
GCTAATGCCCA -> CTAATGCCCAA
GCTAGACTGGA -> CTAGACTGGAA
GCTAGATAGAT -> CTAGATAGATA
GCTAGCACACA -> CTAGCACACAA
GCTAGGACTAC -> CTAGGACTACC
GCTAGTACCTA -> CTAGTACCTAA
GCTATGTATGC -> CTATGTATGCG
GCTCAACGTGT -> CTCAACGTGTC
GCTCAGGGCTT -> CTCAGGGCTTA
GCTCATCTGGA -> CTCATCTGGAG
GCTCATTTGAT -> CTCATTTGATA
GCTCATTTGGG -> CTCATTTGGGC
GCTCCAGGTCG -> CTCCAGGTCGG
GCTCCCGGTTC -> CTCCCGGTTCG
GCTCCTCGAAT -> CTCCTCGAATC
GCTCTTTCAAG -> CTCTTTCAAGG
GCTGCCCGCGA -> CTGCCCGCGAT
GCTGCCCTAGG -> CTGCCCTAGGC
GCTGCGCAGAA -> CTGCGCAGAAC
GCTGCTTTTCT -> CTGCTTTTCTA
GCTGTTAATAA -> CTGTTAATAAT
GCTGTTTGCAC -> CTGTTTGCACA
GCTTAATCGGT -> CTTAATCGGTA
GCTTATAGATG -> CTTATAGATGC
GCTTCCCACAA -> CTTCCCACAAA
GCTTCCTTTTC -> CTTCCTTTTCT
GCTTGCGCCAA -> CTTGCGCCAAC
GCTTGCTCATC -> CTTGCTCATCT
GCTTGTCGATA -> CTTGTCGATAT
GCTTTACGAGT -> CTTTACGAGTC
GCTTTCCGGTA -> CTTTCCGGTAC
GCTTTTCTAGT -> CTTTTCTAGTG
GGAAACGGGCG -> GAAACGGGCGA
GGAACGAGTAC -> GAACGAGTACC
GGAAGCGAAGC -> GAAGCGAAGCG
GGAAGTCGACT -> GAAGTCGACTA
GGAATGACCCT -> GAATGACCCTT
GGACACCCCAC -> GACACCCCACG
GGACCGGCTCC -> GACCGGCTCCT
GGACCTCTTGC -> GACCTCTTGCC
GGACGGAACGA -> GACGGAACGAG
GGACTACCCTT -> GACTACCCTTA
GGACTAGAATC -> GACTAGAATCG
GGACTCGGCTG -> GACTCGGCTGC
GGACTCGTCCA -> GACTCGTCCAG
GGAGAAATCCG -> GAGAAATCCGC
GGAGACAGCAT -> GAGACAGCATA
GGAGCGCAAGG -> GAGCGCAAGGG
GGAGCGTTGGC -> GAGCGTTGGCC
GGAGTCTCTCC -> GAGTCTCTCCA
GGAGTGCCCGA -> GAGTGCCCGAT
GGAGTTCTCTC -> GAGTTCTCTCG
GGATACATATC -> GATACATATCC
GGATAGGCGGC -> GATAGGCGGCC
GGATATAGTAT -> GATATAGTATG
GGATATTGTAG -> GATATTGTAGC
GGATCAGACCG -> GATCAGACCGG
GGATCATAGCT -> GATCATAGCTT
GGATGCACACT -> GATGCACACTA
GGATGGTATGT -> GATGGTATGTC
GGATTCACCCG -> GATTCACCCGC
GGATTTAGTGG -> GATTTAGTGGA
GGCAACACGAT -> GCAACACGATC
GGCACACAAGT -> GCACACAAGTC
GGCACTGATAC -> GCACTGATACT
GGCACTGGATC -> GCACTGGATCA
GGCAGCAAAGC -> GCAGCAAAGCG
GGCAGCCCTAG -> GCAGCCCTAGC
GGCAGGATATT -> GCAGGATATTG
GGCATACGCCT -> GCATACGCCTC
GGCATAGACAC -> GCATAGACACC
GGCATGCGACA -> GCATGCGACAA
GGCCCTTCGGT -> GCCCTTCGGTC
GGCCGCGAACC -> GCCGCGAACCC
GGCCGTACAGG -> GCCGTACAGGT
GGCCGTTTATC -> GCCGTTTATCA
GGCCTATATGA -> GCCTATATGAC
GGCCTCAGCAC -> GCCTCAGCACT
GGCGAAACACC -> GCGAAACACCG
GGCGAGAGTAA -> GCGAGAGTAAA
GGCGATCCGCC -> GCGATCCGCCG
GGCGCTCTTTC -> GCGCTCTTTCA
GGCGGAAGCGA -> GCGGAAGCGAA
GGCGGCCTCAG -> GCGGCCTCAGC
GGCTAGATAGA -> GCTAGATAGAT
GGCTATGTATG -> GCTATGTATGC
GGCTCAACGTG -> GCTCAACGTGT
GGCTCATTTGA -> GCTCATTTGAT
GGCTCATTTGG -> GCTCATTTGGG
GGCTCCTCGAA -> GCTCCTCGAAT
GGCTGCGCAGA -> GCTGCGCAGAA
GGCTGCTTTTC -> GCTGCTTTTCT
GGCTGTTAATA -> GCTGTTAATAA
GGCTGTTTGCA -> GCTGTTTGCAC
GGCTTATAGAT -> GCTTATAGATG
GGGAAACGGGC -> GGAAACGGGCG
GGGAAGTCGAC -> GGAAGTCGACT
GGGACGGAACG -> GGACGGAACGA
GGGACTCGTCC -> GGACTCGTCCA
GGGATGCACAC -> GGATGCACACT
GGGATGGTATG -> GGATGGTATGT
GGGATTCACCC -> GGATTCACCCG
GGGATTTAGTG -> GGATTTAGTGG
GGGCATACGCC -> GGCATACGCCT
GGGCGAGAGTA -> GGCGAGAGTAA
GGGCGATCCGC -> GGCGATCCGCC
GGGCTATGTAT -> GGCTATGTATG
GGGCTGCTTTT -> GGCTGCTTTTC
GGGCTGTTTGC -> GGCTGTTTGCA
GGGCTTATAGA -> GGCTTATAGAT
GGGGATGGTAT -> GGGATGGTATG
GGGGATTCACC -> GGGATTCACCC
GGGGCTGCTTT -> GGGCTGCTTTT
GGGGGATGGTA -> GGGGATGGTAT
GGGGGATTCAC -> GGGGATTCACC
GGGGGCTGCTT -> GGGGCTGCTTT
GGGGGGATGGT -> GGGGGATGGTA
GGGGGGGATGG -> GGGGGGATGGT
GGGGGGGGATG -> GGGGGGGATGG
GGGGTGCCAAA -> GGGTGCCAAAC
GGGGTGTACAG -> GGGTGTACAGA
GGGTCATCACT -> GGTCATCACTA
GGGTCGAAACC -> GGTCGAAACCG
GGGTGCCAAAC -> GGTGCCAAACA
GGGTGCGTGGT -> GGTGCGTGGTA
GGGTGTACAGA -> GGTGTACAGAC
GGGTTTCGCCA -> GGTTTCGCCAT
GGTAACAATAT -> GTAACAATATA
GGTAATGGGCT -> GTAATGGGCTG
GGTACGCTAGG -> GTACGCTAGGA
GGTAGATTAAA -> GTAGATTAAAC
GGTATCTAAGG -> GTATCTAAGGG
GGTATGTCGGC -> GTATGTCGGCA
GGTATTGTCTC -> GTATTGTCTCC
GGTCATCACTA -> GTCATCACTAT
GGTCGAAACCG -> GTCGAAACCGC
GGTCGAAATTG -> GTCGAAATTGC
GGTCGAGCCTA -> GTCGAGCCTAT
GGTCGCAAATC -> GTCGCAAATCG
GGTCGGCCCTT -> GTCGGCCCTTC
GGTCGTGAGTA -> GTCGTGAGTAG
GGTCGTGGATA -> GTCGTGGATAG
GGTGCAATGGG -> GTGCAATGGGT
GGTGCCAAACA -> GTGCCAAACAT
GGTGCCTGTAC -> GTGCCTGTACA
GGTGCGCACGA -> GTGCGCACGAA
GGTGCGGTAGA -> GTGCGGTAGAT
GGTGCGTGGTA -> GTGCGTGGTAA
GGTGGCTCAAC -> GTGGCTCAACG
GGTGGCTCATT -> GTGGCTCATTT
GGTGTACAGAC -> GTGTACAGACA
GGTGTACCCAC -> GTGTACCCACC
GGTTACGCAAA -> GTTACGCAAAA
GGTTCACTCAG -> GTTCACTCAGC
GGTTCATTCCC -> GTTCATTCCCT
GGTTCGAAATA -> GTTCGAAATAA
GGTTCGCGAGA -> GTTCGCGAGAG
GGTTGATTAGG -> GTTGATTAGGG
GGTTTACAGGA -> GTTTACAGGAC
GGTTTCGCCAT -> GTTTCGCCATT
GGTTTCTGATA -> GTTTCTGATAG
GTAAAGGAGTG -> TAAAGGAGTGC
GTAACAATATA -> TAACAATATAC
GTAAGTGAGCA -> TAAGTGAGCAC
GTAATGGGCTG -> TAATGGGCTGT
GTACAACGAGG -> TACAACGAGGA
GTACAGACAAG -> TACAGACAAGT
GTACAGGTTCG -> TACAGGTTCGC
GTACCCACCTT -> TACCCACCTTT
GTACCGTTGAG -> TACCGTTGAGT
GTACCTAACGA -> TACCTAACGAC
GTACGCTAGGA -> TACGCTAGGAC
GTACTGAACTG -> TACTGAACTGA
GTACTGGTGCG -> TACTGGTGCGG
GTAGATTAAAC -> TAGATTAAACC
GTAGCGTTCCC -> TAGCGTTCCCT
GTAGGAGCGCA -> TAGGAGCGCAA
GTAGGCGAAAC -> TAGGCGAAACA
GTAGGTTGATT -> TAGGTTGATTA
GTATAGACGTG -> TATAGACGTGC
GTATCTAAGGG -> TATCTAAGGGA
GTATGAGACAC -> TATGAGACACA
GTATGCAGGCG -> TATGCAGGCGG
GTATGCGCTTA -> TATGCGCTTAA
GTATGGAGTTC -> TATGGAGTTCT
GTATGTCGGCA -> TATGTCGGCAT
GTATTGTCTCC -> TATTGTCTCCA
GTATTTCTTGA -> TATTTCTTGAG
GTCAATTTTCG -> TCAATTTTCGG
GTCACTACCAG -> TCACTACCAGA
GTCAGCGTGGA -> TCAGCGTGGAT
GTCAGGCAACA -> TCAGGCAACAC
GTCATCACTAT -> TCATCACTATC
GTCATTAAATC -> TCATTAAATCG
GTCCAGACGTT -> TCCAGACGTTC
GTCCAGCCCTG -> TCCAGCCCTGT
GTCGAAACCGC -> TCGAAACCGCA
GTCGAAATTGC -> TCGAAATTGCA
GTCGACTACCA -> TCGACTACCAA
GTCGAGCCTAT -> TCGAGCCTATC
GTCGATATAGA -> TCGATATAGAT
GTCGCAAATCG -> TCGCAAATCGG
GTCGCTTTCCG -> TCGCTTTCCGG
GTCGGCATGCG -> TCGGCATGCGA
GTCGGCCCTTC -> TCGGCCCTTCG
GTCGTGAGTAG -> TCGTGAGTAGG
GTCGTGGATAG -> TCGTGGATAGG
GTCTAACCACC -> TCTAACCACCG
GTCTCCAACTC -> TCTCCAACTCC
GTCTCCTCTTT -> TCTCCTCTTTG
GTCTCGTGTTG -> TCTCGTGTTGA
GTCTCTCCACT -> TCTCTCCACTT
GTCTGCCCATG -> TCTGCCCATGT
GTCTGTACTGA -> TCTGTACTGAA
GTCTGTTAACA -> TCTGTTAACAT
GTGACACTCGC -> TGACACTCGCG
GTGACTTGTCT -> TGACTTGTCTC
GTGAGCACTCT -> TGAGCACTCTT
GTGAGTAGGCG -> TGAGTAGGCGA
GTGATAGGTTT -> TGATAGGTTTA
GTGCAAGTGCT -> TGCAAGTGCTT
GTGCAATGGGT -> TGCAATGGGTT
GTGCCAAACAT -> TGCCAAACATA
GTGCCACTATA -> TGCCACTATAG
GTGCCCGATGG -> TGCCCGATGGT
GTGCCTGTACA -> TGCCTGTACAA
GTGCGAGGGTC -> TGCGAGGGTCA
GTGCGCACGAA -> TGCGCACGAAG
GTGCGGTAGAT -> TGCGGTAGATT
GTGCGTAGGAG -> TGCGTAGGAGC
GTGCGTGGTAA -> TGCGTGGTAAC
GTGCTAAGGGA -> TGCTAAGGGAT
GTGCTAGCACA -> TGCTAGCACAC
GTGCTAGTACC -> TGCTAGTACCT
GTGCTTCCCAC -> TGCTTCCCACA
GTGGAGACAGC -> TGGAGACAGCA
GTGGATACATA -> TGGATACATAT
GTGGATAGGCG -> TGGATAGGCGG
GTGGATCATAG -> TGGATCATAGC
GTGGCCGTACA -> TGGCCGTACAG
GTGGCTCAACG -> TGGCTCAACGT
GTGGCTCATTT -> TGGCTCATTTG
GTGGGGTGTAC -> TGGGGTGTACA
GTGGTAACAAT -> TGGTAACAATA
GTGGTTCATTC -> TGGTTCATTCC
GTGTAAGTGAG -> TGTAAGTGAGC
GTGTACAGACA -> TGTACAGACAA
GTGTACCCACC -> TGTACCCACCT
GTGTAGGTTGA -> TGTAGGTTGAT
GTGTCAGCGTG -> TGTCAGCGTGG
GTGTCCAGACG -> TGTCCAGACGT
GTGTGCGAGGG -> TGTGCGAGGGT
GTGTTGAGGCA -> TGTTGAGGCAC
GTTAACATGCT -> TTAACATGCTC
GTTAATAATTT -> TTAATAATTTG
GTTACGCAAAA -> TTACGCAAAAT
GTTACTTTGGG -> TTACTTTGGGC
GTTCAACGTCT -> TTCAACGTCTG
GTTCACTCAGC -> TTCACTCAGCG
GTTCATTCCCT -> TTCATTCCCTG
GTTCCCTCGCA -> TTCCCTCGCAC
GTTCCTCACAG -> TTCCTCACAGA
GTTCGAAATAA -> TTCGAAATAAC
GTTCGCGAGAG -> TTCGCGAGAGG
GTTCTCTCGAA -> TTCTCTCGAAC
GTTGAGGCACT -> TTGAGGCACTG
GTTGAGTGTCA -> TTGAGTGTCAG
GTTGATTAGGG -> TTGATTAGGGC
GTTGGCCGTTT -> TTGGCCGTTTA
GTTGTACTGGT -> TTGTACTGGTG
GTTTACAGGAC -> TTTACAGGACC
GTTTATCAACT -> TTTATCAACTT
GTTTCGCCATT -> TTTCGCCATTT
GTTTCTGATAG -> TTTCTGATAGG
GTTTGCACATA -> TTTGCACATAT
TAAACAACCGA -> AAACAACCGAA
TAAACCCCTAG -> AAACCCCTAGA
TAAACGCTTCC -> AAACGCTTCCT
TAAAGGAGTGC -> AAAGGAGTGCC
TAAAGGGGGCT -> AAAGGGGGCTG
TAAATCGAGCG -> AAATCGAGCGA
TAACAATATAC -> AACAATATACG
TAACACCGCAG -> AACACCGCAGC
TAACATACGAT -> AACATACGATG
TAACATGCTCA -> AACATGCTCAG
TAACCACCGAT -> AACCACCGATC
TAACGACGACA -> AACGACGACAG
TAACGAGCAGT -> AACGAGCAGTC
TAACGGCACTG -> AACGGCACTGA
TAACGTCTCGT -> AACGTCTCGTG
TAACTATCGCA -> AACTATCGCAG
TAAGGGACTCG -> AAGGGACTCGT
TAAGGGATTTA -> AAGGGATTTAG
TAAGGTTACGC -> AAGGTTACGCA
TAAGTGAGCAC -> AAGTGAGCACT
TAAGTGCTAGT -> AAGTGCTAGTA
TAATAATTTGG -> AATAATTTGGC
TAATCATCCGC -> AATCATCCGCA
TAATCATTCAA -> AATCATTCAAC
TAATCGGTATT -> AATCGGTATTG
TAATGCCCAAT -> AATGCCCAATT
TAATGGGCTGT -> AATGGGCTGTT
TAATTTGGCAC -> AATTTGGCACA
TACAACGAGGA -> ACAACGAGGAT
TACAGACAAGT -> ACAGACAAGTG
TACAGGACCGG -> ACAGGACCGGC
TACAGGTTCGC -> ACAGGTTCGCG
TACATATCCGT -> ACATATCCGTG
TACATCCAGAC -> ACATCCAGACT
TACCAAGGCAG -> ACCAAGGCAGC
TACCAGATTTC -> ACCAGATTTCG
TACCCACCTTT -> ACCCACCTTTT
TACCCTTAAAG -> ACCCTTAAAGG
TACCGTTGAGT -> ACCGTTGAGTG
TACCTAACGAC -> ACCTAACGACG
TACGAACCGCC -> ACGAACCGCCC
TACGACAGAGA -> ACGACAGAGAC
TACGAGTCGCT -> ACGAGTCGCTT
TACGATGCGAT -> ACGATGCGATA
TACGCAAAATT -> ACGCAAAATTC
TACGCCTCCTT -> ACGCCTCCTTC
TACGCGTGGCC -> ACGCGTGGCCG
TACGCTAGGAC -> ACGCTAGGACT
TACGGCTGTTA -> ACGGCTGTTAA
TACTGAACTGA -> ACTGAACTGAC
TACTGGTGCCT -> ACTGGTGCCTG
TACTGGTGCGG -> ACTGGTGCGGT
TACTTTGGGCG -> ACTTTGGGCGA
TAGAATCGATG -> AGAATCGATGA
TAGACACCCGT -> AGACACCCGTA
TAGACGTGCTA -> AGACGTGCTAA
TAGACTGGAAT -> AGACTGGAATG
TAGAGCGGACT -> AGAGCGGACTA
TAGATAACTAT -> AGATAACTATC
TAGATAGATAA -> AGATAGATAAC
TAGATGCATTT -> AGATGCATTTC
TAGATGGGATG -> AGATGGGATGC
TAGATTAAACC -> AGATTAAACCC
TAGCACACAAT -> AGCACACAATC
TAGCACAGGTC -> AGCACAGGTCG
TAGCAGGCTCA -> AGCAGGCTCAT
TAGCATTCCAG -> AGCATTCCAGT
TAGCGAGACCC -> AGCGAGACCCT
TAGCGTTCCCT -> AGCGTTCCCTC
TAGCTGCCCGC -> AGCTGCCCGCG
TAGCTTTACGA -> AGCTTTACGAG
TAGGACTACCC -> AGGACTACCCT
TAGGAGCGCAA -> AGGAGCGCAAG
TAGGCCGCGAA -> AGGCCGCGAAC
TAGGCGAAACA -> AGGCGAAACAC
TAGGCGGCCTC -> AGGCGGCCTCA
TAGGGCATACG -> AGGGCATACGC
TAGGGGTGCCA -> AGGGGTGCCAA
TAGGTTGATTA -> AGGTTGATTAG
TAGGTTTACAG -> AGGTTTACAGG
TAGTACCTAAC -> AGTACCTAACG
TAGTATGAGAC -> AGTATGAGACA
TAGTATGCAGG -> AGTATGCAGGC
TAGTGACTTGT -> AGTGACTTGTC
TAGTGGAGACA -> AGTGGAGACAG
TATACGACAGA -> ATACGACAGAG
TATACGCGTGG -> ATACGCGTGGC
TATAGACGTGC -> ATAGACGTGCT
TATAGATGCAT -> ATAGATGCATT
TATAGATGGGA -> ATAGATGGGAT
TATAGCATTCC -> ATAGCATTCCA
TATAGCGAGAC -> ATAGCGAGACC
TATAGTATGAG -> ATAGTATGAGA
TATAGTATGCA -> ATAGTATGCAG
TATATGACCCG -> ATATGACCCGC
TATCAACTTTC -> ATCAACTTTCT
TATCACACCGA -> ATCACACCGAG
TATCCGTGGAT -> ATCCGTGGATC
TATCGCAGCCA -> ATCGCAGCCAG
TATCTAAGGGA -> ATCTAAGGGAC
TATCTACGGCT -> ATCTACGGCTG
TATGACCCGCT -> ATGACCCGCTC
TATGAGACACA -> ATGAGACACAC
TATGCAGGCGG -> ATGCAGGCGGA
TATGCGCTTAA -> ATGCGCTTAAT
TATGGAGTTCT -> ATGGAGTTCTC
TATGTATGCGC -> ATGTATGCGCT
TATGTCGGCAT -> ATGTCGGCATG
TATGTGTGCGA -> ATGTGTGCGAG
TATTCTTGTTC -> ATTCTTGTTCA
TATTGTAGCGT -> ATTGTAGCGTT
TATTGTCTCCA -> ATTGTCTCCAA
TATTTCTTGAG -> ATTTCTTGAGC
TCAACGTCTGT -> CAACGTCTGTT
TCAACGTGTCC -> CAACGTGTCCA
TCAACTTTCCC -> CAACTTTCCCT
TCAACTTTCTG -> CAACTTTCTGT
TCAAGGTCGCA -> CAAGGTCGCAA
TCAATTTTCGG -> CAATTTTCGGT
TCACAAATAGC -> CACAAATAGCT
TCACACCGAGA -> CACACCGAGAC
TCACAGAGTCT -> CACAGAGTCTG
TCACCCGCTTG -> CACCCGCTTGC
TCACTACCAGA -> CACTACCAGAT
TCACTATCACA -> CACTATCACAC
TCACTCAGCGG -> CACTCAGCGGT
TCAGACCGGTT -> CAGACCGGTTC
TCAGCGGTTTC -> CAGCGGTTTCT
TCAGCGTGGAT -> CAGCGTGGATA
TCAGGCAACAC -> CAGGCAACACG
TCAGGGCTTAT -> CAGGGCTTATA
TCATAGCTTTA -> CATAGCTTTAC
TCATCACTATC -> CATCACTATCA
TCATCCGCACT -> CATCCGCACTG
TCATCGAACGG -> CATCGAACGGC
TCATCTGGAGA -> CATCTGGAGAA
TCATTAAATCG -> CATTAAATCGA
TCATTCAACTT -> CATTCAACTTT
TCATTCCCTGG -> CATTCCCTGGG
TCATTTGATAT -> CATTTGATATA
TCATTTGGGCT -> CATTTGGGCTA
TCCAACTCCTT -> CCAACTCCTTG
TCCAATTTTCC -> CCAATTTTCCG
TCCACTTCTGC -> CCACTTCTGCC
TCCAGACGTTC -> CCAGACGTTCC
TCCAGACTAAG -> CCAGACTAAGT
TCCAGATAAAC -> CCAGATAAACG
TCCAGCCCTGT -> CCAGCCCTGTC
TCCAGGTCGGC -> CCAGGTCGGCC
TCCAGTGGTTC -> CCAGTGGTTCA
TCCATCGAAAC -> CCATCGAAACG
TCCCACAAAGG -> CCCACAAAGGA
TCCCGGTTCGA -> CCCGGTTCGAA
TCCCTAATCAT -> CCCTAATCATT
TCCCTACGAAC -> CCCTACGAACC
TCCCTCGCACT -> CCCTCGCACTT
TCCCTGGGTGC -> CCCTGGGTGCG
TCCCTGGTGGC -> CCCTGGTGGCT
TCCGCACTACA -> CCGCACTACAT
TCCGCACTGCA -> CCGCACTGCAC
TCCGCCGACAT -> CCGCCGACATA
TCCGCCTTATG -> CCGCCTTATGT
TCCGGTACGCT -> CCGGTACGCTA
TCCGTGGATCA -> CCGTGGATCAT
TCCTCACAGAG -> CCTCACAGAGT
TCCTCGAATCT -> CCTCGAATCTC
TCCTCTTTGGC -> CCTCTTTGGCG
TCCTTCCAATT -> CCTTCCAATTT
TCCTTGCGAAA -> CCTTGCGAAAG
TCCTTTTCTAA -> CCTTTTCTAAC
TCGAAACCGCA -> CGAAACCGCAA
TCGAAACGAAA -> CGAAACGAAAT
TCGAAATAACG -> CGAAATAACGG
TCGAAATTGCA -> CGAAATTGCAT
TCGAACGGCCT -> CGAACGGCCTA
TCGAACGTCAG -> CGAACGTCAGG
TCGAATCTCCC -> CGAATCTCCCT
TCGACTACCAA -> CGACTACCAAG
TCGAGCCTATC -> CGAGCCTATCT
TCGAGCGAGCG -> CGAGCGAGCGC
TCGATATAGAT -> CGATATAGATG
TCGATGATTGT -> CGATGATTGTG
TCGCAAATCGG -> CGCAAATCGGT
TCGCACTTCCA -> CGCACTTCCAT
TCGCAGCCAGC -> CGCAGCCAGCA
TCGCCATTTGA -> CGCCATTTGAC
TCGCGAGAGGA -> CGCGAGAGGAG
TCGCGCTTGTC -> CGCGCTTGTCG
TCGCTTGCTCA -> CGCTTGCTCAT
TCGCTTTCCGG -> CGCTTTCCGGT
TCGGCATGCGA -> CGGCATGCGAC
TCGGCCCTTCG -> CGGCCCTTCGG
TCGGCTGCGCA -> CGGCTGCGCAG
TCGGGACGGAA -> CGGGACGGAAC
TCGGTAATGGG -> CGGTAATGGGC
TCGGTATTGTC -> CGGTATTGTCT
TCGGTCGAAAT -> CGGTCGAAATT
TCGGTCGTGAG -> CGGTCGTGAGT
TCGTCCAGCCC -> CGTCCAGCCCT
TCGTGAGTAGG -> CGTGAGTAGGC
TCGTGCAAGTG -> CGTGCAAGTGC
TCGTGCGTAGG -> CGTGCGTAGGA
TCGTGGATAGG -> CGTGGATAGGC
TCGTGTTGAGG -> CGTGTTGAGGC
TCTAACACCGC -> CTAACACCGCA
TCTAACCACCG -> CTAACCACCGA
TCTAACGTCTC -> CTAACGTCTCG
TCTAAGGGACT -> CTAAGGGACTC
TCTACGGCTGT -> CTACGGCTGTT
TCTAGTGACTT -> CTAGTGACTTG
TCTCCAACTCC -> CTCCAACTCCT
TCTCCACTTCT -> CTCCACTTCTG
TCTCCCTACGA -> CTCCCTACGAA
TCTCCTCTTTG -> CTCCTCTTTGG
TCTCGAACGTC -> CTCGAACGTCA
TCTCGTGTTGA -> CTCGTGTTGAG
TCTCTCCACTT -> CTCTCCACTTC
TCTCTCGAACG -> CTCTCGAACGT
TCTGATAGGGG -> CTGATAGGGGT
TCTGCCCATGT -> CTGCCCATGTG
TCTGCCTGCTA -> CTGCCTGCTAA
TCTGGAGAAAT -> CTGGAGAAATC
TCTGGTATCTA -> CTGGTATCTAA
TCTGTACTGAA -> CTGTACTGAAC
TCTGTCACTAC -> CTGTCACTACC
TCTGTTAACAT -> CTGTTAACATG
TCTTGACGTAT -> CTTGACGTATG
TCTTGAGCGCG -> CTTGAGCGCGC
TCTTGCCGTGG -> CTTGCCGTGGG
TCTTGGGGGGG -> CTTGGGGGGGG
TCTTGTTCAAC -> CTTGTTCAACG
TCTTTCAAGGT -> CTTTCAAGGTC
TCTTTCACAAA -> CTTTCACAAAT
TCTTTGGCGCT -> CTTTGGCGCTC
TGAACTGACGT -> GAACTGACGTG
TGAATGCGTCT -> GAATGCGTCTG
TGACACCGTTG -> GACACCGTTGT
TGACACTCGCG -> GACACTCGCGC
TGACCCGCTCC -> GACCCGCTCCA
TGACCCTTGCT -> GACCCTTGCTC
TGACGTATGGA -> GACGTATGGAG
TGACGTATTTC -> GACGTATTTCT
TGACGTGTAGG -> GACGTGTAGGT
TGACTTGTCTC -> GACTTGTCTCC
TGAGACACACG -> GAGACACACGG
TGAGCACTCTT -> GAGCACTCTTG
TGAGCGCGCGG -> GAGCGCGCGGG
TGAGGCACTGG -> GAGGCACTGGA
TGAGTAGGCGA -> GAGTAGGCGAA
TGAGTGTCAGC -> GAGTGTCAGCG
TGATACTGGTG -> GATACTGGTGC
TGATAGGGGTG -> GATAGGGGTGC
TGATAGGTTTA -> GATAGGTTTAC
TGATATAGTAT -> GATATAGTATG
TGATTAGGGCA -> GATTAGGGCAT
TGATTGTGACA -> GATTGTGACAC
TGCAAGTGCTT -> GCAAGTGCTTC
TGCAATGGGTT -> GCAATGGGTTT
TGCACACTAAC -> GCACACTAACA
TGCACATATAC -> GCACATATACG
TGCACCCAGGT -> GCACCCAGGTG
TGCAGGCGGAA -> GCAGGCGGAAG
TGCATTGGACT -> GCATTGGACTC
TGCATTTCGTG -> GCATTTCGTGC
TGCCAAACATA -> GCCAAACATAA
TGCCACTATAG -> GCCACTATAGC
TGCCCAATTGC -> GCCCAATTGCG
TGCCCATGTGC -> GCCCATGTGCC
TGCCCGATGGT -> GCCCGATGGTG
TGCCCGCGATT -> GCCCGCGATTT
TGCCCTAGGCC -> GCCCTAGGCCG
TGCCGTGGGGT -> GCCGTGGGGTG
TGCCTGCTAAT -> GCCTGCTAATG
TGCCTGTACAA -> GCCTGTACAAC
TGCGAAAGGCA -> GCGAAAGGCAG
TGCGACAAATC -> GCGACAAATCC
TGCGAGGGTCA -> GCGAGGGTCAT
TGCGATAATCA -> GCGATAATCAT
TGCGCACGAAG -> GCGCACGAAGC
TGCGCAGAACT -> GCGCAGAACTC
TGCGCCAACCA -> GCGCCAACCAT
TGCGCTTAATC -> GCGCTTAATCG
TGCGGCTAGAT -> GCGGCTAGATA
TGCGGTAGATT -> GCGGTAGATTA
TGCGTAGGAGC -> GCGTAGGAGCG
TGCGTCTGCCC -> GCGTCTGCCCA
TGCGTGGTAAC -> GCGTGGTAACA
TGCTAAGGGAT -> GCTAAGGGATT
TGCTAATGCCC -> GCTAATGCCCA
TGCTAGCACAC -> GCTAGCACACA
TGCTAGTACCT -> GCTAGTACCTA
TGCTCAGGGCT -> GCTCAGGGCTT
TGCTCATCTGG -> GCTCATCTGGA
TGCTCCCGGTT -> GCTCCCGGTTC
TGCTGCCCTAG -> GCTGCCCTAGG
TGCTTCCCACA -> GCTTCCCACAA
TGCTTTTCTAG -> GCTTTTCTAGT
TGGAATGACCC -> GGAATGACCCT
TGGACTCGGCT -> GGACTCGGCTG
TGGAGAAATCC -> GGAGAAATCCG
TGGAGACAGCA -> GGAGACAGCAT
TGGAGTTCTCT -> GGAGTTCTCTC
TGGATACATAT -> GGATACATATC
TGGATAGGCGG -> GGATAGGCGGC
TGGATCAGACC -> GGATCAGACCG
TGGATCATAGC -> GGATCATAGCT
TGGCACACAAG -> GGCACACAAGT
TGGCATAGACA -> GGCATAGACAC
TGGCCGTACAG -> GGCCGTACAGG
TGGCCGTTTAT -> GGCCGTTTATC
TGGCGCTCTTT -> GGCGCTCTTTC
TGGCTCAACGT -> GGCTCAACGTG
TGGCTCATTTG -> GGCTCATTTGA
TGGGAAACGGG -> GGGAAACGGGC
TGGGATGCACA -> GGGATGCACAC
TGGGCGATCCG -> GGGCGATCCGC
TGGGCTATGTA -> GGGCTATGTAT
TGGGCTGTTTG -> GGGCTGTTTGC
TGGGGGGGGAT -> GGGGGGGGATG
TGGGGTGTACA -> GGGGTGTACAG
TGGGTCGAAAC -> GGGTCGAAACC
TGGGTGCGTGG -> GGGTGCGTGGT
TGGGTTTCGCC -> GGGTTTCGCCA
TGGTAACAATA -> GGTAACAATAT
TGGTATCTAAG -> GGTATCTAAGG
TGGTATGTCGG -> GGTATGTCGGC
TGGTGCCTGTA -> GGTGCCTGTAC
TGGTGCGGTAG -> GGTGCGGTAGA
TGGTGGCTCAA -> GGTGGCTCAAC
TGGTGGCTCAT -> GGTGGCTCATT
TGGTGTACCCA -> GGTGTACCCAC
TGGTTCATTCC -> GGTTCATTCCC
TGTAAGTGAGC -> GTAAGTGAGCA
TGTACAACGAG -> GTACAACGAGG
TGTACAGACAA -> GTACAGACAAG
TGTACCCACCT -> GTACCCACCTT
TGTACTGAACT -> GTACTGAACTG
TGTACTGGTGC -> GTACTGGTGCG
TGTAGCGTTCC -> GTAGCGTTCCC
TGTAGGTTGAT -> GTAGGTTGATT
TGTATGCGCTT -> GTATGCGCTTA
TGTCACTACCA -> GTCACTACCAG
TGTCAGCGTGG -> GTCAGCGTGGA
TGTCCAGACGT -> GTCCAGACGTT
TGTCGATATAG -> GTCGATATAGA
TGTCGGCATGC -> GTCGGCATGCG
TGTCTAACCAC -> GTCTAACCACC
TGTCTCCAACT -> GTCTCCAACTC
TGTCTCCTCTT -> GTCTCCTCTTT
TGTGACACTCG -> GTGACACTCGC
TGTGCCACTAT -> GTGCCACTATA
TGTGCGAGGGT -> GTGCGAGGGTC
TGTGTGCGAGG -> GTGTGCGAGGG
TGTTAACATGC -> GTTAACATGCT
TGTTAATAATT -> GTTAATAATTT
TGTTCAACGTC -> GTTCAACGTCT
TGTTGAGGCAC -> GTTGAGGCACT
TGTTTGCACAT -> GTTTGCACATA
TTAAACCCCTA -> TAAACCCCTAG
TTAAAGGGGGC -> TAAAGGGGGCT
TTAAATCGAGC -> TAAATCGAGCG
TTAACATGCTC -> TAACATGCTCA
TTAATAATTTG -> TAATAATTTGG
TTAATCGGTAT -> TAATCGGTATT
TTACAGGACCG -> TACAGGACCGG
TTACGAGTCGC -> TACGAGTCGCT
TTACGCAAAAT -> TACGCAAAATT
TTACTTTGGGC -> TACTTTGGGCG
TTAGGGCATAC -> TAGGGCATACG
TTAGTGGAGAC -> TAGTGGAGACA
TTATAGATGCA -> TATAGATGCAT
TTATAGCATTC -> TATAGCATTCC
TTATCAACTTT -> TATCAACTTTC
TTATGTGTGCG -> TATGTGTGCGA
TTCAACGTCTG -> TCAACGTCTGT
TTCAACTTTCC -> TCAACTTTCCC
TTCAAGGTCGC -> TCAAGGTCGCA
TTCACAAATAG -> TCACAAATAGC
TTCACCCGCTT -> TCACCCGCTTG
TTCACTCAGCG -> TCACTCAGCGG
TTCATTCCCTG -> TCATTCCCTGG
TTCCAATTTTC -> TCCAATTTTCC
TTCCAGTGGTT -> TCCAGTGGTTC
TTCCATCGAAA -> TCCATCGAAAC
TTCCCACAAAG -> TCCCACAAAGG
TTCCCTCGCAC -> TCCCTCGCACT
TTCCCTGGGTG -> TCCCTGGGTGC
TTCCCTGGTGG -> TCCCTGGTGGC
TTCCGCACTAC -> TCCGCACTACA
TTCCGGTACGC -> TCCGGTACGCT
TTCCTCACAGA -> TCCTCACAGAG
TTCCTTTTCTA -> TCCTTTTCTAA
TTCGAAATAAC -> TCGAAATAACG
TTCGCCATTTG -> TCGCCATTTGA
TTCGCGAGAGG -> TCGCGAGAGGA
TTCGCTTGCTC -> TCGCTTGCTCA
TTCGGTAATGG -> TCGGTAATGGG
TTCGGTCGAAA -> TCGGTCGAAAT
TTCGTGCAAGT -> TCGTGCAAGTG
TTCTAACGTCT -> TCTAACGTCTC
TTCTAGTGACT -> TCTAGTGACTT
TTCTCTCGAAC -> TCTCTCGAACG
TTCTGATAGGG -> TCTGATAGGGG
TTCTGCCTGCT -> TCTGCCTGCTA
TTCTGTCACTA -> TCTGTCACTAC
TTCTTGAGCGC -> TCTTGAGCGCG
TTCTTGTTCAA -> TCTTGTTCAAC
TTCTTTCACAA -> TCTTTCACAAA
TTGACGTATGG -> TGACGTATGGA
TTGACGTATTT -> TGACGTATTTC
TTGAGCGCGCG -> TGAGCGCGCGG
TTGAGGCACTG -> TGAGGCACTGG
TTGAGTGTCAG -> TGAGTGTCAGC
TTGATATAGTA -> TGATATAGTAT
TTGATTAGGGC -> TGATTAGGGCA
TTGCACATATA -> TGCACATATAC
TTGCATTGGAC -> TGCATTGGACT
TTGCCGTGGGG -> TGCCGTGGGGT
TTGCGAAAGGC -> TGCGAAAGGCA
TTGCGCCAACC -> TGCGCCAACCA
TTGCGGCTAGA -> TGCGGCTAGAT
TTGCTCATCTG -> TGCTCATCTGG
TTGCTCCCGGT -> TGCTCCCGGTT
TTGCTGCCCTA -> TGCTGCCCTAG
TTGGACTCGGC -> TGGACTCGGCT
TTGGCACACAA -> TGGCACACAAG
TTGGCATAGAC -> TGGCATAGACA
TTGGCCGTTTA -> TGGCCGTTTAT
TTGGCGCTCTT -> TGGCGCTCTTT
TTGGGAAACGG -> TGGGAAACGGG
TTGGGCGATCC -> TGGGCGATCCG
TTGGGCTATGT -> TGGGCTATGTA
TTGGGGGGGGA -> TGGGGGGGGAT
TTGTACTGGTG -> TGTACTGGTGC
TTGTAGCGTTC -> TGTAGCGTTCC
TTGTCGATATA -> TGTCGATATAG
TTGTCTCCAAC -> TGTCTCCAACT
TTGTCTCCTCT -> TGTCTCCTCTT
TTGTGACACTC -> TGTGACACTCG
TTGTTCAACGT -> TGTTCAACGTC
TTTACAGGACC -> TTACAGGACCG
TTTACGAGTCG -> TTACGAGTCGC
TTTAGTGGAGA -> TTAGTGGAGAC
TTTATAGCATT -> TTATAGCATTC
TTTATCAACTT -> TTATCAACTTT
TTTCAAGGTCG -> TTCAAGGTCGC
TTTCACAAATA -> TTCACAAATAG
TTTCCCTGGTG -> TTCCCTGGTGG
TTTCCGCACTA -> TTCCGCACTAC
TTTCCGGTACG -> TTCCGGTACGC
TTTCGCCATTT -> TTCGCCATTTG
TTTCGCTTGCT -> TTCGCTTGCTC
TTTCGGTAATG -> TTCGGTAATGG
TTTCGTGCAAG -> TTCGTGCAAGT
TTTCTAACGTC -> TTCTAACGTCT
TTTCTAGTGAC -> TTCTAGTGACT
TTTCTGATAGG -> TTCTGATAGGG
TTTCTGTCACT -> TTCTGTCACTA
TTTCTTGAGCG -> TTCTTGAGCGC
TTTGACGTATT -> TTGACGTATTT
TTTGATATAGT -> TTGATATAGTA
TTTGCACATAT -> TTGCACATATA
TTTGGCACACA -> TTGGCACACAA
TTTGGCATAGA -> TTGGCATAGAC
TTTGGCGCTCT -> TTGGCGCTCTT
TTTGGGCGATC -> TTGGGCGATCC
TTTGGGCTATG -> TTGGGCTATGT
TTTTATAGCAT -> TTTATAGCATT
TTTTCCGCACT -> TTTCCGCACTA
TTTTCGGTAAT -> TTTCGGTAATG
TTTTCTAACGT -> TTTCTAACGTC
TTTTCTAGTGA -> TTTCTAGTGAC
TTTTGGCATAG -> TTTGGCATAGA
TTTTTGGCATA -> TTTTGGCATAG
