AAAACCATGGA -> AAACCATGGAC
AAAATACACGC -> AAATACACGCG
AAAATTAGTAA -> AAATTAGTAAT
AAAATTCTTAG -> AAATTCTTAGC
AAACCATGAAG -> AACCATGAAGG
AAACCATGGAC -> AACCATGGACC
AAACGAGAGCA -> AACGAGAGCAT
AAACGCTAGAG -> AACGCTAGAGC
AAACTAGCACT -> AACTAGCACTG
AAACTTTGTTC -> AACTTTGTTCT
AAAGACAGCGC -> AAGACAGCGCG
AAAGATAATAA -> AAGATAATAAC
AAAGCCTTCAT -> AAGCCTTCATA
AAAGCTCTGAG -> AAGCTCTGAGC
AAAGTACGGTC -> AAGTACGGTCC
AAAGTCGGCGC -> AAGTCGGCGCG
AAAGTTCTTTT -> AAGTTCTTTTT
AAATACACGCG -> AATACACGCGA
AAATCAGTAAG -> AATCAGTAAGG
AAATCTAGGCA -> AATCTAGGCAT
AAATGCGGAAT -> AATGCGGAATC
AAATTAGCCTG -> AATTAGCCTGT
AAATTAGTAAT -> AATTAGTAATA
AAATTATCGAC -> AATTATCGACC
AAATTCTTAGC -> AATTCTTAGCG
AACAAGATTCT -> ACAAGATTCTA
AACACGCATTG -> ACACGCATTGA
AACAGCCACCG -> ACAGCCACCGA
AACAGGGTGTC -> ACAGGGTGTCT
AACATCGCTGC -> ACATCGCTGCT
AACCAACTCTG -> ACCAACTCTGG
AACCACAACGT -> ACCACAACGTA
AACCATGAAGG -> ACCATGAAGGG
AACCATGGACC -> ACCATGGACCC
AACCGCCCTAC -> ACCGCCCTACC
AACCGTGATGA -> ACCGTGATGAA
AACGAGAGCAT -> ACGAGAGCATT
AACGCGCGACC -> ACGCGCGACCT
AACGCTAGAGC -> ACGCTAGAGCG
AACGTAAGACA -> ACGTAAGACAC
AACGTTGATTG -> ACGTTGATTGG
AACTACAAGAC -> ACTACAAGACT
AACTACAAGTC -> ACTACAAGTCT
AACTAGCACTG -> ACTAGCACTGT
AACTCCTGAAG -> ACTCCTGAAGG
AACTCGGATGT -> ACTCGGATGTC
AACTCTGGGAA -> ACTCTGGGAAT
AACTGGGCAGC -> ACTGGGCAGCG
AACTGGTTTTT -> ACTGGTTTTTC
AACTTTAGGGA -> ACTTTAGGGAA
AACTTTGTTCT -> ACTTTGTTCTT
AAGACACCATC -> AGACACCATCA
AAGACAGCGCG -> AGACAGCGCGA
AAGACATCTTT -> AGACATCTTTC
AAGACCCCAAT -> AGACCCCAATT
AAGACTTATCG -> AGACTTATCGC
AAGAGCCAGGC -> AGAGCCAGGCA
AAGATAATAAC -> AGATAATAACT
AAGATTCTAAC -> AGATTCTAACT
AAGCAAACGAG -> AGCAAACGAGA
AAGCAGTGGAA -> AGCAGTGGAAG
AAGCCCCGTCG -> AGCCCCGTCGG
AAGCCTTCATA -> AGCCTTCATAA
AAGCGACGGCA -> AGCGACGGCAT
AAGCGAGCAGT -> AGCGAGCAGTC
AAGCTACATCG -> AGCTACATCGT
AAGCTCAAACT -> AGCTCAAACTA
AAGCTCTGAGC -> AGCTCTGAGCT
AAGCTGAAAAT -> AGCTGAAAATT
AAGCTGCATTT -> AGCTGCATTTG
AAGCTTCGTGT -> AGCTTCGTGTC
AAGGATACCTG -> AGGATACCTGA
AAGGCCTGATT -> AGGCCTGATTA
AAGGCGCGCAC -> AGGCGCGCACC
AAGGCTTAAGT -> AGGCTTAAGTC
AAGGGCGACTA -> AGGGCGACTAA
AAGGTGTACAG -> AGGTGTACAGA
AAGTACGGTCC -> AGTACGGTCCC
AAGTCAAGCTG -> AGTCAAGCTGA
AAGTCAGATAA -> AGTCAGATAAG
AAGTCAGGAGA -> AGTCAGGAGAG
AAGTCATCCGT -> AGTCATCCGTG
AAGTCGGCGCG -> AGTCGGCGCGA
AAGTCTAACAG -> AGTCTAACAGC
AAGTCTCGCTT -> AGTCTCGCTTA
AAGTGCGTCGA -> AGTGCGTCGAT
AAGTGGTACAC -> AGTGGTACACC
AAGTTCTTTTT -> AGTTCTTTTTG
AAGTTTCAACC -> AGTTTCAACCA
AATAAAACCAT -> ATAAAACCATG
AATAACTACAA -> ATAACTACAAG,ATAACTACAAG
AATAATGATCG -> ATAATGATCGT
AATACACGCGA -> ATACACGCGAG
AATAGAATGCA -> ATAGAATGCAC
AATAGCAGCTC -> ATAGCAGCTCC
AATATCGACCG -> ATATCGACCGC
AATATTCTGAC -> ATATTCTGACA
AATCAGTAAGG -> ATCAGTAAGGC
AATCCGCAAAG -> ATCCGCAAAGA
AATCCGCCTAC -> ATCCGCCTACT
AATCGAAAGTA -> ATCGAAAGTAC
AATCGGATCCA -> ATCGGATCCAT
AATCTAGGCAT -> ATCTAGGCATT
AATCTCGTATG -> ATCTCGTATGG
AATGAAATGCG -> ATGAAATGCGG
AATGATCGTCG -> ATGATCGTCGC
AATGCACTACG -> ATGCACTACGG
AATGCCTTGTC -> ATGCCTTGTCC
AATGCGGAATC -> ATGCGGAATCT
AATGTAGAATT -> ATGTAGAATTC
AATGTCCGTAG -> ATGTCCGTAGG
AATGTGAATAG -> ATGTGAATAGA
AATTAAAGATA -> ATTAAAGATAA
AATTAGCCTGT -> ATTAGCCTGTC
AATTAGTAATA -> ATTAGTAATAT
AATTATAAGTC -> ATTATAAGTCT
AATTATCGACC -> ATTATCGACCG
AATTCGTCGAC -> ATTCGTCGACT
AATTCGTTTTA -> ATTCGTTTTAT
AATTCTAGCCC -> ATTCTAGCCCA
AATTCTTAGCG -> ATTCTTAGCGG
AATTGATGAGC -> ATTGATGAGCA
AATTTAAGAGC -> ATTTAAGAGCC
ACAACGTAAGA -> CAACGTAAGAC
ACAAGACTTAT -> CAAGACTTATC
ACAAGATTCTA -> CAAGATTCTAA
ACAAGGATACC -> CAAGGATACCT
ACAAGTCTAAC -> CAAGTCTAACA
ACAAGTGGTAC -> CAAGTGGTACA
ACAATGTAGAA -> CAATGTAGAAT
ACACCATCATA -> CACCATCATAG
ACACCCGATGC -> CACCCGATGCG
ACACGATTGTA -> CACGATTGTAT
ACACGCATTGA -> CACGCATTGAC
ACACGCGAGCT -> CACGCGAGCTC
ACACTAATAGC -> CACTAATAGCA
ACAGACTAGGC -> CAGACTAGGCA
ACAGCCACCGA -> CAGCCACCGAC
ACAGCGCGATT -> CAGCGCGATTA
ACAGCTGCTCG -> CAGCTGCTCGT
ACAGGGTGTCT -> CAGGGTGTCTG
ACAGTATCTAG -> CAGTATCTAGG
ACATAACAGGG -> CATAACAGGGT
ACATAGAGATG -> CATAGAGATGA
ACATCGCTGCT -> CATCGCTGCTG
ACATCGTAATG -> CATCGTAATGT
ACATCTTTCGT -> CATCTTTCGTT
ACATTTGAGAA -> CATTTGAGAAT
ACCAACTCTGG -> CCAACTCTGGG
ACCAATGAAAT -> CCAATGAAATG
ACCACAACGTA -> CCACAACGTAA
ACCATCATAGT -> CCATCATAGTA
ACCATGAAGGG -> CCATGAAGGGC
ACCATGGACCC -> CCATGGACCCC
ACCCCAATTGA -> CCCCAATTGAT
ACCCCATAGAT -> CCCCATAGATC
ACCCCGTGCAA -> CCCCGTGCAAA
ACCCCTGTGCT -> CCCCTGTGCTC
ACCCGACGCTT -> CCCGACGCTTA
ACCCGATGCGC -> CCCGATGCGCC
ACCGACGCCTT -> CCGACGCCTTA
ACCGACTTACG -> CCGACTTACGG
ACCGCATTAGA -> CCGCATTAGAT
ACCGCCCTACC -> CCGCCCTACCC
ACCGCTCGCGT -> CCGCTCGCGTA
ACCGGAGGCGC -> CCGGAGGCGCA
ACCGGGCATGT -> CCGGGCATGTC
ACCGTGATGAA -> CCGTGATGAAG
ACCTCCCGGGA -> CCTCCCGGGAT
ACCTCTAGCCC -> CCTCTAGCCCG
ACCTGATTTTG -> CCTGATTTTGG
ACGACGCGCGG -> CGACGCGCGGA
ACGAGAGCATT -> CGAGAGCATTC
ACGATAGCTCG -> CGATAGCTCGT
ACGATTGTATG -> CGATTGTATGC
ACGCAAGGCCT -> CGCAAGGCCTG
ACGCATGCTGG -> CGCATGCTGGA
ACGCATTGACC -> CGCATTGACCC
ACGCCTACCTC -> CGCCTACCTCC
ACGCCTGGATC -> CGCCTGGATCA
ACGCCTTATAG -> CGCCTTATAGG
ACGCGAGCTCT -> CGCGAGCTCTA
ACGCGCGACCT -> CGCGCGACCTC
ACGCGCGGACG -> CGCGCGGACGG
ACGCGCTCGGT -> CGCGCTCGGTC
ACGCGTGCAGA -> CGCGTGCAGAT
ACGCTAGAGCG -> CGCTAGAGCGA
ACGCTTAAAGT -> CGCTTAAAGTC
ACGGCATTATT -> CGGCATTATTT
ACGGGAGGGTG -> CGGGAGGGTGC
ACGGTAGCACC -> CGGTAGCACCG
ACGGTATAGAG -> CGGTATAGAGG
ACGGTCCCTGC -> CGGTCCCTGCC
ACGGTCCTGGG -> CGGTCCTGGGC
ACGGTCTCATT -> CGGTCTCATTG
ACGTAAGACAC -> CGTAAGACACC
ACGTAAGCTCA -> CGTAAGCTCAA
ACGTCCGGCCA -> CGTCCGGCCAA
ACGTGGTCCCA -> CGTGGTCCCAG
ACGTTAGCGGA -> CGTTAGCGGAT
ACGTTGATTGG -> CGTTGATTGGT
ACGTTTTGGGT -> CGTTTTGGGTC
ACTAACTGGTT -> CTAACTGGTTT
ACTAATAGCAG -> CTAATAGCAGC
ACTAATCGAAA -> CTAATCGAAAG
ACTACAAGACT -> CTACAAGACTT
ACTACAAGTCT -> CTACAAGTCTA
ACTACCCCTGT -> CTACCCCTGTG
ACTACGGTCCT -> CTACGGTCCTG
ACTAGCACTGT -> CTAGCACTGTG
ACTAGGCATGT -> CTAGGCATGTT
ACTATAATCGG -> CTATAATCGGA
ACTATTGACAT -> CTATTGACATT
ACTCCGGGGTA -> CTCCGGGGTAG
ACTCCTCTGTC -> CTCCTCTGTCA
ACTCCTGAAGG -> CTCCTGAAGGT
ACTCCTGGAAC -> CTCCTGGAACG
ACTCGGATGTC -> CTCGGATGTCC
ACTCTGGGAAT -> CTCTGGGAATC
ACTGAACTCGG -> CTGAACTCGGA
ACTGATGAACA -> CTGATGAACAT
ACTGCTTCCTC -> CTGCTTCCTCC
ACTGGATCTCT -> CTGGATCTCTG
ACTGGGCAGCG -> CTGGGCAGCGA
ACTGGTTTTTC -> CTGGTTTTTCT
ACTGTGATCTC -> CTGTGATCTCA
ACTTACGGGAG -> CTTACGGGAGG
ACTTATCGCGT -> CTTATCGCGTC
ACTTTAGGGAA -> CTTTAGGGAAT
ACTTTGTTCTT -> CTTTGTTCTTC
AGAAAGTTCTT -> GAAAGTTCTTT
AGAACCGTGAT -> GAACCGTGATG
AGAATGCACTA -> GAATGCACTAC
AGAATTCGTTT -> GAATTCGTTTT
AGAATTCTAGC -> GAATTCTAGCC
AGAATTTAAGA -> GAATTTAAGAG
AGACACCATCA -> GACACCATCAT
AGACACTAATA -> GACACTAATAG
AGACAGCGCGA -> GACAGCGCGAT
AGACATCTTTC -> GACATCTTTCG
AGACCCCAATT -> GACCCCAATTG
AGACTAGGCAT -> GACTAGGCATG
AGACTTATCGC -> GACTTATCGCG
AGAGAGATGTG -> GAGAGATGTGA
AGAGATGACAG -> GAGATGACAGC
AGAGATGTGAA -> GAGATGTGAAA
AGAGCATTCTG -> GAGCATTCTGT
AGAGCCAGGCA -> GAGCCAGGCAA
AGAGCGATTTG -> GAGCGATTTGT
AGAGGCAGTCC -> GAGGCAGTCCA
AGATAAGCGAG -> GATAAGCGAGC
AGATAATAACT -> GATAATAACTA
AGATACGTTAG -> GATACGTTAGC
AGATACGTTTT -> GATACGTTTTG
AGATATTCAGT -> GATATTCAGTT
AGATCACGCCT -> GATCACGCCTG
AGATCCCCACC -> GATCCCCACCA
AGATGACAGCT -> GATGACAGCTG
AGATGTGAAAA -> GATGTGAAAAT
AGATTCCTTAG -> GATTCCTTAGG
AGATTCTAACT -> GATTCTAACTG
AGCAAACGAGA -> GCAAACGAGAG
AGCAAGCAGTG -> GCAAGCAGTGG
AGCACCGCATT -> GCACCGCATTA
AGCACTGTGAT -> GCACTGTGATC
AGCAGCTCCTA -> GCAGCTCCTAC
AGCAGTCGTAG -> GCAGTCGTAGA
AGCAGTGGAAG -> GCAGTGGAAGA
AGCATTCTGTG -> GCATTCTGTGT
AGCCACCGACG -> GCCACCGACGC
AGCCAGGCAAG -> GCCAGGCAAGC
AGCCCAGGATT -> GCCCAGGATTA
AGCCCCGTCGG -> GCCCCGTCGGG
AGCCCGAAATC -> GCCCGAAATCA
AGCCGTGCACT -> GCCGTGCACTA
AGCCTGGATAC -> GCCTGGATACG
AGCCTGTCGTA -> GCCTGTCGTAA
AGCCTTCATAA -> GCCTTCATAAA
AGCCTTCGACG -> GCCTTCGACGC
AGCGAAACGCT -> GCGAAACGCTA
AGCGACGGCAT -> GCGACGGCATT
AGCGACTGGAT -> GCGACTGGATC
AGCGAGCAGTC -> GCGAGCAGTCG
AGCGATTTGTG -> GCGATTTGTGT
AGCGCGATTAC -> GCGCGATTACG
AGCGCTTCGCA -> GCGCTTCGCAT
AGCGGATCCAG -> GCGGATCCAGT
AGCGGGGGCCG -> GCGGGGGCCGC
AGCGTCCTATC -> GCGTCCTATCA
AGCTACATCGT -> GCTACATCGTA
AGCTACTCCGG -> GCTACTCCGGG
AGCTAGGGAAT -> GCTAGGGAATA
AGCTCAAACTA -> GCTCAAACTAG
AGCTCCTACGA -> GCTCCTACGAT
AGCTCGTATAA -> GCTCGTATAAA
AGCTCTACTGA -> GCTCTACTGAA
AGCTCTGAGCT -> GCTCTGAGCTA
AGCTGAAAATT -> GCTGAAAATTA
AGCTGCAATCC -> GCTGCAATCCG
AGCTGCATTTG -> GCTGCATTTGC
AGCTGCTCGTG -> GCTGCTCGTGG
AGCTTCGTGTC -> GCTTCGTGTCA
AGGACTATTGA -> GGACTATTGAC
AGGACTCCTCT -> GGACTCCTCTG
AGGAGAGAGAT -> GGAGAGAGATG
AGGATACCTGA -> GGATACCTGAT
AGGATATCGCC -> GGATATCGCCT
AGGATTATGCA -> GGATTATGCAA
AGGCAAGCTTC -> GGCAAGCTTCG
AGGCAGTCCAT -> GGCAGTCCATC
AGGCATCCTGA -> GGCATCCTGAC
AGGCATGTTTT -> GGCATGTTTTC
AGGCATTATGA -> GGCATTATGAA
AGGCCTGATTA -> GGCCTGATTAA
AGGCGCAATAA -> GGCGCAATAAC
AGGCGCGCACC -> GGCGCGCACCG
AGGCTACGGTC -> GGCTACGGTCT
AGGCTTAAGTC -> GGCTTAAGTCA
AGGGAAACTTT -> GGGAAACTTTG
AGGGAATAATG -> GGGAATAATGA
AGGGAATATTC -> GGGAATATTCT
AGGGCAGCGAA -> GGGCAGCGAAA
AGGGCCTGGCC -> GGGCCTGGCCA
AGGGCGACTAA -> GGGCGACTAAC
AGGGGTAACCA -> GGGGTAACCAA
AGGGTGCTCAG -> GGGTGCTCAGC
AGGGTGTCTGC -> GGGTGTCTGCG
AGGGTTCGCAG -> GGGTTCGCAGA
AGGTGACAAGG -> GGTGACAAGGA
AGGTGCGGTCT -> GGTGCGGTCTC
AGGTGTACAGA -> GGTGTACAGAC
AGTAACGTTGA -> GTAACGTTGAT
AGTAAGGCTTA -> GTAAGGCTTAA
AGTAAGTCAAG -> GTAAGTCAAGC
AGTAATATCGA -> GTAATATCGAC
AGTACGGTCCC -> GTACGGTCCCT
AGTACTGATGA -> GTACTGATGAA
AGTAGTAACGT -> GTAGTAACGTT
AGTATCTAGGG -> GTATCTAGGGC
AGTCAAGCTGA -> GTCAAGCTGAA
AGTCAGATAAG -> GTCAGATAAGC
AGTCAGGAGAG -> GTCAGGAGAGA
AGTCATCCGTG -> GTCATCCGTGT
AGTCCATCTCG -> GTCCATCTCGA
AGTCCCATCAG -> GTCCCATCAGG
AGTCGGCGCGA -> GTCGGCGCGAT
AGTCGTAGAAA -> GTCGTAGAAAG
AGTCTAACAGC -> GTCTAACAGCC
AGTCTCGCTTA -> GTCTCGCTTAC
AGTCTTTGTTT -> GTCTTTGTTTC
AGTGCGTCGAT -> GTGCGTCGATA
AGTGGAAGACA -> GTGGAAGACAT
AGTGGTACACC -> GTGGTACACCC
AGTTCCTATCT -> GTTCCTATCTG
AGTTCTTTTTG -> GTTCTTTTTGG
AGTTGAGCCTG -> GTTGAGCCTGG
AGTTTCAACCA -> GTTTCAACCAC
ATAAAACCATG -> TAAAACCATGG
ATAAAATTCTT -> TAAAATTCTTA
ATAAAGCCTTC -> TAAAGCCTTCA
ATAACAAGATT -> TAACAAGATTC
ATAACAGGGTG -> TAACAGGGTGT
ATAACTACAAG -> TAACTACAAGA,TAACTACAAGT
ATAAGCGAGCA -> TAAGCGAGCAG
ATAAGTCTCGC -> TAAGTCTCGCT
ATAATAACTAC -> TAATAACTACA
ATAATCGGATC -> TAATCGGATCC
ATAATGATCGT -> TAATGATCGTC
ATACACGCGAG -> TACACGCGAGC
ATACCTGATTT -> TACCTGATTTT
ATACGTAAGCT -> TACGTAAGCTC
ATACGTTAGCG -> TACGTTAGCGG
ATACGTTTTGG -> TACGTTTTGGG
ATACTACCCCT -> TACTACCCCTG
ATAGAATGCAC -> TAGAATGCACT
ATAGAATTTAA -> TAGAATTTAAG
ATAGAGATGAC -> TAGAGATGACA
ATAGAGGCAGT -> TAGAGGCAGTC
ATAGATCCCCA -> TAGATCCCCAC
ATAGCAGCTCC -> TAGCAGCTCCT
ATAGCTCGTAT -> TAGCTCGTATA
ATAGGCTACGG -> TAGGCTACGGT
ATAGGGCAGCG -> TAGGGCAGCGA
ATAGTAGTAAC -> TAGTAGTAACG
ATATCGACCGC -> TATCGACCGCT
ATATCGCCTGC -> TATCGCCTGCC
ATATGCGAAGA -> TATGCGAAGAC
ATATGTGTAGG -> TATGTGTAGGA
ATATTCAGTTC -> TATTCAGTTCC
ATATTCTGACA -> TATTCTGACAA
ATCAAGTCATC -> TCAAGTCATCC
ATCACGCCTGG -> TCACGCCTGGA
ATCACTCCTGG -> TCACTCCTGGA
ATCAGGTGACA -> TCAGGTGACAA
ATCAGTAAGGC -> TCAGTAAGGCT
ATCATAGTAGT -> TCATAGTAGTA
ATCATTCTAAG -> TCATTCTAAGC
ATCCAGTACTG -> TCCAGTACTGA
ATCCATCGCCA -> TCCATCGCCAA
ATCCCCACCAA -> TCCCCACCAAT
ATCCGCAAAGA -> TCCGCAAAGAC
ATCCGCCTACT -> TCCGCCTACTG
ATCCGTGTTAA -> TCCGTGTTAAG
ATCCTGACATA -> TCCTGACATAA
ATCCTTTTGTA -> TCCTTTTGTAT
ATCGAAACCAT -> TCGAAACCATG
ATCGAAAGTAC -> TCGAAAGTACG
ATCGACCGCTC -> TCGACCGCTCG
ATCGACCGGGC -> TCGACCGGGCA
ATCGCCAATCC -> TCGCCAATCCG
ATCGCCTGCCT -> TCGCCTGCCTG
ATCGCGTCAAG -> TCGCGTCAAGT
ATCGCTCCACC -> TCGCTCCACCG
ATCGCTGCTGT -> TCGCTGCTGTA
ATCGGATCCAT -> TCGGATCCATC
ATCGGTATCAA -> TCGGTATCAAG
ATCGTAATGTC -> TCGTAATGTCC
ATCGTCGCCCC -> TCGTCGCCCCC
ATCGTGGACGC -> TCGTGGACGCA
ATCTAGGCATT -> TCTAGGCATTA
ATCTAGGGCCT -> TCTAGGGCCTG
ATCTCAAGTGC -> TCTCAAGTGCG
ATCTCGATTCG -> TCTCGATTCGG
ATCTCGTATGG -> TCTCGTATGGG
ATCTCTGTAGC -> TCTCTGTAGCC
ATCTGAATTCG -> TCTGAATTCGT
ATCTTTCGTTC -> TCTTTCGTTCC
ATCTTTTATCG -> TCTTTTATCGA
ATGAAATGCGG -> TGAAATGCGGA
ATGAACATCGC -> TGAACATCGCT
ATGAAGGGCGA -> TGAAGGGCGAC
ATGAAGTCAGA -> TGAAGTCAGAT
ATGAATGTGAA -> TGAATGTGAAT
ATGAATTATAA -> TGAATTATAAG
ATGACAGCTGC -> TGACAGCTGCT
ATGAGCAAGCA -> TGAGCAAGCAG
ATGATCGTCGC -> TGATCGTCGCC
ATGCAACTTTA -> TGCAACTTTAG
ATGCACTACGG -> TGCACTACGGT
ATGCCTCTCGT -> TGCCTCTCGTA
ATGCCTTGTCC -> TGCCTTGTCCA
ATGCGAAGACC -> TGCGAAGACCC
ATGCGCCCGAT -> TGCGCCCGATC
ATGCGGAATCT -> TGCGGAATCTC
ATGCTCGGCAT -> TGCTCGGCATC
ATGCTGGAAGC -> TGCTGGAAGCC
ATGGACCCCGT -> TGGACCCCGTG
ATGGGGGGATT -> TGGGGGGATTG
ATGTAGAATTC -> TGTAGAATTCG
ATGTCATATGC -> TGTCATATGCG
ATGTCCCACGT -> TGTCCCACGTC
ATGTCCGTAGG -> TGTCCGTAGGG
ATGTGAAAATA -> TGTGAAAATAC
ATGTGAATAGA -> TGTGAATAGAA
ATGTGTAGGAC -> TGTGTAGGACT
ATGTTTTCTAC -> TGTTTTCTACA
ATTAAAGATAA -> TTAAAGATAAT
ATTAATGCCTT -> TTAATGCCTTG
ATTACGGTATA -> TTACGGTATAG
ATTAGAACCGT -> TTAGAACCGTG
ATTAGATATTC -> TTAGATATTCA
ATTAGCCTGTC -> TTAGCCTGTCG
ATTAGCTAGGG -> TTAGCTAGGGA
ATTAGTAATAT -> TTAGTAATATC
ATTATAAGTCT -> TTATAAGTCTC
ATTATCGACCG -> TTATCGACCGG
ATTATGAATTA -> TTATGAATTAT
ATTATGCAACT -> TTATGCAACTT
ATTATTTGACA -> TTATTTGACAT
ATTCAGATTCC -> TTCAGATTCCT
ATTCAGTTCCT -> TTCAGTTCCTA
ATTCCGTTTAA -> TTCCGTTTAAG
ATTCCTTAGGG -> TTCCTTAGGGT
ATTCGGGTAGT -> TTCGGGTAGTC
ATTCGTCGACT -> TTCGTCGACTA
ATTCGTTTTAT -> TTCGTTTTATG
ATTCTAACTGG -> TTCTAACTGGG
ATTCTAAGCAA -> TTCTAAGCAAA
ATTCTAGCCCA -> TTCTAGCCCAG
ATTCTGACAAT -> TTCTGACAATG
ATTCTGTGTGC -> TTCTGTGTGCG
ATTCTTAGCGG -> TTCTTAGCGGG
ATTGAACCGCC -> TTGAACCGCCC
ATTGACATTTG -> TTGACATTTGA
ATTGACCCCAT -> TTGACCCCATA
ATTGATGAGCA -> TTGATGAGCAA
ATTGGTCCCGC -> TTGGTCCCGCT
ATTGTATGCTC -> TTGTATGCTCG
ATTGTCTTAAT -> TTGTCTTAATT
ATTGTGCCCTG -> TTGTGCCCTGT
ATTTAAGAGCC -> TTTAAGAGCCA
ATTTGACATAG -> TTTGACATAGA
ATTTGAGAATT -> TTTGAGAATTC
ATTTGCATTAG -> TTTGCATTAGC
ATTTGTGTGAG -> TTTGTGTGAGA
ATTTTGGATAG -> TTTTGGATAGG
ATTTTTTGAGT -> TTTTTTGAGTA
CAAACGAGAGC -> AAACGAGAGCA
CAAACTAGCAC -> AAACTAGCACT
CAAAGACAGCG -> AAAGACAGCGC
CAAATTAGCCT -> AAATTAGCCTG
CAACACGCATT -> AACACGCATTG
CAACCACAACG -> AACCACAACGT
CAACGTAAGAC -> AACGTAAGACA
CAACTCCTGAA -> AACTCCTGAAG
CAACTCTGGGA -> AACTCTGGGAA
CAACTTTAGGG -> AACTTTAGGGA
CAAGACTTATC -> AAGACTTATCG
CAAGATTCTAA -> AAGATTCTAAC
CAAGCAGTGGA -> AAGCAGTGGAA
CAAGCTGAAAA -> AAGCTGAAAAT
CAAGCTTCGTG -> AAGCTTCGTGT
CAAGGATACCT -> AAGGATACCTG
CAAGGCCTGAT -> AAGGCCTGATT
CAAGTCATCCG -> AAGTCATCCGT
CAAGTCTAACA -> AAGTCTAACAG
CAAGTGCGTCG -> AAGTGCGTCGA
CAAGTGGTACA -> AAGTGGTACAC
CAAGTTTCAAC -> AAGTTTCAACC
CAATAACTACA -> AATAACTACAA
CAATCCGCAAA -> AATCCGCAAAG
CAATCCGCCTA -> AATCCGCCTAC
CAATGAAATGC -> AATGAAATGCG
CAATGTAGAAT -> AATGTAGAATT
CAATTGATGAG -> AATTGATGAGC
CACAACGTAAG -> ACAACGTAAGA
CACAAGTGGTA -> ACAAGTGGTAC
CACAGTATCTA -> ACAGTATCTAG
CACCAATGAAA -> ACCAATGAAAT
CACCATCATAG -> ACCATCATAGT
CACCCGATGCG -> ACCCGATGCGC
CACCGACGCCT -> ACCGACGCCTT
CACCGACTTAC -> ACCGACTTACG
CACCGCATTAG -> ACCGCATTAGA
CACCGGAGGCG -> ACCGGAGGCGC
CACGACGCGCG -> ACGACGCGCGG
CACGATTGTAT -> ACGATTGTATG
CACGCATTGAC -> ACGCATTGACC
CACGCCTGGAT -> ACGCCTGGATC
CACGCGAGCTC -> ACGCGAGCTCT
CACGTCCGGCC -> ACGTCCGGCCA
CACTAATAGCA -> ACTAATAGCAG
CACTACGGTCC -> ACTACGGTCCT
CACTATAATCG -> ACTATAATCGG
CACTCCTGGAA -> ACTCCTGGAAC
CACTGTGATCT -> ACTGTGATCTC
CAGACTAGGCA -> AGACTAGGCAT
CAGATAAGCGA -> AGATAAGCGAG
CAGATACGTTA -> AGATACGTTAG
CAGATACGTTT -> AGATACGTTTT
CAGATTCCTTA -> AGATTCCTTAG
CAGCCACCGAC -> AGCCACCGACG
CAGCGAAACGC -> AGCGAAACGCT
CAGCGACTGGA -> AGCGACTGGAT
CAGCGCGATTA -> AGCGCGATTAC
CAGCGTCCTAT -> AGCGTCCTATC
CAGCTCCTACG -> AGCTCCTACGA
CAGCTGCTCGT -> AGCTGCTCGTG
CAGGAGAGAGA -> AGGAGAGAGAT
CAGGATTATGC -> AGGATTATGCA
CAGGCAAGCTT -> AGGCAAGCTTC
CAGGCATCCTG -> AGGCATCCTGA
CAGGGGTAACC -> AGGGGTAACCA
CAGGGTGTCTG -> AGGGTGTCTGC
CAGGTGACAAG -> AGGTGACAAGG
CAGTAAGGCTT -> AGTAAGGCTTA
CAGTACTGATG -> AGTACTGATGA
CAGTATCTAGG -> AGTATCTAGGG
CAGTCCATCTC -> AGTCCATCTCG
CAGTCGTAGAA -> AGTCGTAGAAA
CAGTGGAAGAC -> AGTGGAAGACA
CAGTTCCTATC -> AGTTCCTATCT
CAGTTGAGCCT -> AGTTGAGCCTG
CATAAAATTCT -> ATAAAATTCTT
CATAACAGGGT -> ATAACAGGGTG
CATAGAGATGA -> ATAGAGATGAC
CATAGATCCCC -> ATAGATCCCCA
CATAGTAGTAA -> ATAGTAGTAAC
CATATGCGAAG -> ATATGCGAAGA
CATATGTGTAG -> ATATGTGTAGG
CATCAGGTGAC -> ATCAGGTGACA
CATCATAGTAG -> ATCATAGTAGT
CATCCGTGTTA -> ATCCGTGTTAA
CATCCTGACAT -> ATCCTGACATA
CATCGCCAATC -> ATCGCCAATCC
CATCGCTGCTG -> ATCGCTGCTGT
CATCGGTATCA -> ATCGGTATCAA
CATCGTAATGT -> ATCGTAATGTC
CATCGTGGACG -> ATCGTGGACGC
CATCTCGATTC -> ATCTCGATTCG
CATCTTTCGTT -> ATCTTTCGTTC
CATGAAGGGCG -> ATGAAGGGCGA
CATGCCTCTCG -> ATGCCTCTCGT
CATGCTGGAAG -> ATGCTGGAAGC
CATGGACCCCG -> ATGGACCCCGT
CATGTCATATG -> ATGTCATATGC
CATGTTTTCTA -> ATGTTTTCTAC
CATTAGATATT -> ATTAGATATTC
CATTAGCTAGG -> ATTAGCTAGGG
CATTATGAATT -> ATTATGAATTA
CATTATTTGAC -> ATTATTTGACA
CATTCCGTTTA -> ATTCCGTTTAA
CATTCTAAGCA -> ATTCTAAGCAA
CATTCTGTGTG -> ATTCTGTGTGC
CATTGAACCGC -> ATTGAACCGCC
CATTGACCCCA -> ATTGACCCCAT
CATTGTCTTAA -> ATTGTCTTAAT
CATTTGAGAAT -> ATTTGAGAATT
CATTTGCATTA -> ATTTGCATTAG
CCAACTCCTGA -> CAACTCCTGAA
CCAACTCTGGG -> CAACTCTGGGA
CCAATCCGCCT -> CAATCCGCCTA
CCAATGAAATG -> CAATGAAATGC
CCAATTGATGA -> CAATTGATGAG
CCACAACGTAA -> CACAACGTAAG
CCACAGTATCT -> CACAGTATCTA
CCACCAATGAA -> CACCAATGAAA
CCACCGACGCC -> CACCGACGCCT
CCACCGACTTA -> CACCGACTTAC
CCACGTCCGGC -> CACGTCCGGCC
CCAGGATTATG -> CAGGATTATGC
CCAGGCAAGCT -> CAGGCAAGCTT
CCAGGCATCCT -> CAGGCATCCTG
CCAGGGGTAAC -> CAGGGGTAACC
CCAGTACTGAT -> CAGTACTGATG
CCAGTTGAGCC -> CAGTTGAGCCT
CCATAGATCCC -> CATAGATCCCC
CCATATGTGTA -> CATATGTGTAG
CCATCAGGTGA -> CATCAGGTGAC
CCATCATAGTA -> CATCATAGTAG
CCATCGCCAAT -> CATCGCCAATC
CCATCTCGATT -> CATCTCGATTC
CCATGAAGGGC -> CATGAAGGGCG
CCATGCCTCTC -> CATGCCTCTCG
CCATGGACCCC -> CATGGACCCCG
CCCAATTGATG -> CCAATTGATGA
CCCACCAATGA -> CCACCAATGAA
CCCACGTCCGG -> CCACGTCCGGC
CCCAGGATTAT -> CCAGGATTATG
CCCAGTTGAGC -> CCAGTTGAGCC
CCCATAGATCC -> CCATAGATCCC
CCCATCAGGTG -> CCATCAGGTGA
CCCCAATTGAT -> CCCAATTGATG
CCCCACCAATG -> CCCACCAATGA
CCCCATAGATC -> CCCATAGATCC
CCCCCGACGCC -> CCCCGACGCCT
CCCCGACGCCT -> CCCGACGCCTA
CCCCGTCGGGA -> CCCGTCGGGAA
CCCCGTGCAAA -> CCCGTGCAAAT
CCCCTGTGCTC -> CCCTGTGCTCA
CCCGAAATCAG -> CCGAAATCAGT
CCCGACGCCTA -> CCGACGCCTAC
CCCGACGCTTA -> CCGACGCTTAA
CCCGATCGCTC -> CCGATCGCTCC
CCCGATGCGCC -> CCGATGCGCCC
CCCGCTAGTCT -> CCGCTAGTCTT
CCCGGGATACT -> CCGGGATACTA
CCCGTCGGGAA -> CCGTCGGGAAG
CCCGTGCAAAT -> CCGTGCAAATT
CCCTACCCGAC -> CCTACCCGACG
CCCTGCCAGGG -> CCTGCCAGGGG
CCCTGTGCTCA -> CCTGTGCTCAC
CCCTGTGGACG -> CCTGTGGACGC
CCGAAATCAGT -> CGAAATCAGTA
CCGACGCCTAC -> CGACGCCTACC
CCGACGCCTTA -> CGACGCCTTAT
CCGACGCTTAA -> CGACGCTTAAA
CCGACTTACGG -> CGACTTACGGG
CCGATCGCTCC -> CGATCGCTCCA
CCGATGCGCCC -> CGATGCGCCCG
CCGATTCAGAT -> CGATTCAGATT
CCGCAAAGACA -> CGCAAAGACAG
CCGCATTAGAT -> CGCATTAGATA
CCGCCACAGTA -> CGCCACAGTAT
CCGCCCTACCC -> CGCCCTACCCG
CCGCCTACTGC -> CGCCTACTGCT
CCGCGGTCCGA -> CGCGGTCCGAT
CCGCTAGTCTT -> CGCTAGTCTTT
CCGCTCGCGTA -> CGCTCGCGTAG
CCGGAGGCGCA -> CGGAGGCGCAA
CCGGCCAACTC -> CGGCCAACTCC
CCGGGATACTA -> CGGGATACTAC
CCGGGCACGAC -> CGGGCACGACG
CCGGGCATGTC -> CGGGCATGTCA
CCGGGGTAGGA -> CGGGGTAGGAT
CCGTAAATCTA -> CGTAAATCTAG
CCGTAGGGAAA -> CGTAGGGAAAC
CCGTCGGGAAG -> CGTCGGGAAGC
CCGTGATGAAG -> CGTGATGAAGT
CCGTGCAAATT -> CGTGCAAATTA
CCGTGCACTAT -> CGTGCACTATA
CCGTGTTAAGG -> CGTGTTAAGGC
CCGTTTAAGCT -> CGTTTAAGCTA
CCTACCCGACG -> CTACCCGACGC
CCTACCTCCCG -> CTACCTCCCGG
CCTACGATAGC -> CTACGATAGCT
CCTACTGCTTC -> CTACTGCTTCC
CCTATCACTCC -> CTATCACTCCT
CCTATCTGAAT -> CTATCTGAATT
CCTCCAGGCAT -> CTCCAGGCATC
CCTCCCGGGAT -> CTCCCGGGATA
CCTCTAGCCCG -> CTCTAGCCCGA
CCTCTCGTAAA -> CTCTCGTAAAG
CCTCTGTCATT -> CTCTGTCATTC
CCTGAAGGTGT -> CTGAAGGTGTA
CCTGACATAAC -> CTGACATAACA
CCTGAGATCAC -> CTGAGATCACG
CCTGATTAATG -> CTGATTAATGC
CCTGATTTTGG -> CTGATTTTGGA
CCTGCCAGGGG -> CTGCCAGGGGT
CCTGCCTGAGA -> CTGCCTGAGAT
CCTGGAACGCG -> CTGGAACGCGC
CCTGGATACGT -> CTGGATACGTA
CCTGGATCATT -> CTGGATCATTC
CCTGGCCATAT -> CTGGCCATATG
CCTGGGCTTCC -> CTGGGCTTCCG
CCTGTCGTAAG -> CTGTCGTAAGC
CCTGTGCTCAC -> CTGTGCTCACA
CCTGTGGACGC -> CTGTGGACGCG
CCTTAGGGTTC -> CTTAGGGTTCG
CCTTATAGGGC -> CTTATAGGGCA
CCTTCATAAAA -> CTTCATAAAAT
CCTTCGACGCG -> CTTCGACGCGT
CCTTGTCCATG -> CTTGTCCATGC
CCTTTTGTATT -> CTTTTGTATTT
CGAAACCATGA -> GAAACCATGAA
CGAAACGCTAG -> GAAACGCTAGA
CGAAAGTACGG -> GAAAGTACGGT
CGAAATCAGTA -> GAAATCAGTAA
CGAAATTATCG -> GAAATTATCGA
CGAAGACCCCA -> GAAGACCCCAA
CGACCGCTCGC -> GACCGCTCGCG
CGACCGGGCAT -> GACCGGGCATG
CGACCTCTAGC -> GACCTCTAGCC
CGACGCCTACC -> GACGCCTACCT
CGACGCCTTAT -> GACGCCTTATA
CGACGCGCGGA -> GACGCGCGGAC
CGACGCGTGCA -> GACGCGTGCAG
CGACGCTTAAA -> GACGCTTAAAG
CGACGGCATTA -> GACGGCATTAT
CGACTAACTGG -> GACTAACTGGT
CGACTAATCGA -> GACTAATCGAA
CGACTGGATCT -> GACTGGATCTC
CGACTTACGGG -> GACTTACGGGA
CGAGAGCATTC -> GAGAGCATTCT
CGAGCAGTCGT -> GAGCAGTCGTA
CGAGCGCTTCG -> GAGCGCTTCGC
CGAGCTCTACT -> GAGCTCTACTG
CGAGGACTATT -> GAGGACTATTG
CGATAGAATTT -> GATAGAATTTA
CGATAGCTCGT -> GATAGCTCGTA
CGATCCTTTTG -> GATCCTTTTGT
CGATCGCTCCA -> GATCGCTCCAC
CGATCTTTTAT -> GATCTTTTATC
CGATGCGCCCG -> GATGCGCCCGA
CGATTACGGTA -> GATTACGGTAT
CGATTAGAACC -> GATTAGAACCG
CGATTCAGATT -> GATTCAGATTC
CGATTCGGGTA -> GATTCGGGTAG
CGATTGTATGC -> GATTGTATGCT
CGATTTGTGTG -> GATTTGTGTGA
CGCAAAGACAG -> GCAAAGACAGC
CGCAACACGCA -> GCAACACGCAT
CGCAAGGCCTG -> GCAAGGCCTGA
CGCAATAACTA -> GCAATAACTAC
CGCACCGGAGG -> GCACCGGAGGC
CGCAGATACGT -> GCAGATACGTT
CGCATCGTGGA -> GCATCGTGGAC
CGCATGCTGGA -> GCATGCTGGAA
CGCATTAGATA -> GCATTAGATAT
CGCATTGACCC -> GCATTGACCCC
CGCCAATCCGC -> GCCAATCCGCC
CGCCACAGTAT -> GCCACAGTATC
CGCCCCCGACG -> GCCCCCGACGC
CGCCCGATCGC -> GCCCGATCGCT
CGCCCTACCCG -> GCCCTACCCGA
CGCCTACCTCC -> GCCTACCTCCC
CGCCTACTGCT -> GCCTACTGCTT
CGCCTGCCTGA -> GCCTGCCTGAG
CGCCTGGATCA -> GCCTGGATCAT
CGCCTTATAGG -> GCCTTATAGGG
CGCGACCTCTA -> GCGACCTCTAG
CGCGAGCGCTT -> GCGAGCGCTTC
CGCGAGCTCTA -> GCGAGCTCTAC
CGCGATCCTTT -> GCGATCCTTTT
CGCGATTACGG -> GCGATTACGGT
CGCGCACCGGA -> GCGCACCGGAG
CGCGCGACCTC -> GCGCGACCTCT
CGCGCGGACGG -> GCGCGGACGGT
CGCGCTCGGTC -> GCGCTCGGTCG
CGCGGACGGTA -> GCGGACGGTAG
CGCGGTCCGAT -> GCGGTCCGATT
CGCGTAGGTGC -> GCGTAGGTGCG
CGCGTCAAGTT -> GCGTCAAGTTT
CGCGTGCAGAT -> GCGTGCAGATA
CGCTAGAGCGA -> GCTAGAGCGAT
CGCTAGTCTTT -> GCTAGTCTTTG
CGCTCCACCGA -> GCTCCACCGAC
CGCTCGCGTAG -> GCTCGCGTAGG
CGCTCGGTCGC -> GCTCGGTCGCG
CGCTGCTGTAG -> GCTGCTGTAGC
CGCTTAAAGTC -> GCTTAAAGTCG
CGCTTACGTGG -> GCTTACGTGGT
CGCTTCGCATC -> GCTTCGCATCG
CGGAATCTCGT -> GGAATCTCGTA
CGGACGGTAGC -> GGACGGTAGCA
CGGAGCCTTCG -> GGAGCCTTCGA
CGGAGGCGCAA -> GGAGGCGCAAT
CGGATCCAGTA -> GGATCCAGTAC
CGGATCCATCG -> GGATCCATCGC
CGGATGTCCCA -> GGATGTCCCAC
CGGCATCGGTA -> GGCATCGGTAT
CGGCATTATTT -> GGCATTATTTG
CGGCCAACTCC -> GGCCAACTCCT
CGGCGCGATCC -> GGCGCGATCCT
CGGGAAGCGAC -> GGGAAGCGACG
CGGGAGGGTGC -> GGGAGGGTGCT
CGGGATACTAC -> GGGATACTACC
CGGGCACGACG -> GGGCACGACGC
CGGGCATGTCA -> GGGCATGTCAT
CGGGGGCCGCG -> GGGGGCCGCGG
CGGGGTAGGAT -> GGGGTAGGATA
CGGGTAGTCCC -> GGGTAGTCCCA
CGGTAGCACCG -> GGTAGCACCGC
CGGTATAGAGG -> GGTATAGAGGC
CGGTATCAAGT -> GGTATCAAGTC
CGGTCCCTGCC -> GGTCCCTGCCA
CGGTCCGATTC -> GGTCCGATTCA
CGGTCCTGGGC -> GGTCCTGGGCT
CGGTCGCGAGC -> GGTCGCGAGCG
CGGTCTCATTG -> GGTCTCATTGT
CGGTCTCGAAA -> GGTCTCGAAAT
CGTAAAGCTCT -> GTAAAGCTCTG
CGTAAATCTAG -> GTAAATCTAGG
CGTAAGACACC -> GTAAGACACCA
CGTAAGCTCAA -> GTAAGCTCAAA
CGTAAGCTGCA -> GTAAGCTGCAT
CGTAATGTCCG -> GTAATGTCCGT
CGTAGAAAGTT -> GTAGAAAGTTC
CGTAGGGAAAC -> GTAGGGAAACT
CGTAGGTGCGG -> GTAGGTGCGGT
CGTATAAAGCC -> GTATAAAGCCT
CGTATGGGGGG -> GTATGGGGGGA
CGTCAAGTTTC -> GTCAAGTTTCA
CGTCCGGCCAA -> GTCCGGCCAAC
CGTCCTATCAC -> GTCCTATCACT
CGTCGACTAAT -> GTCGACTAATC
CGTCGATAGAA -> GTCGATAGAAT
CGTCGCCCCCG -> GTCGCCCCCGA
CGTCGGGAAGC -> GTCGGGAAGCG
CGTGATGAAGT -> GTGATGAAGTC
CGTGCAAATTA -> GTGCAAATTAG
CGTGCACTATA -> GTGCACTATAA
CGTGCAGATAC -> GTGCAGATACG
CGTGGACGCAA -> GTGGACGCAAG
CGTGGCGATTA -> GTGGCGATTAG
CGTGGTCCCAG -> GTGGTCCCAGT
CGTGTCATTGA -> GTGTCATTGAA
CGTGTTAAGGC -> GTGTTAAGGCG
CGTTAGCGGAT -> GTTAGCGGATC
CGTTCCGGGCA -> GTTCCGGGCAC
CGTTGATTGGT -> GTTGATTGGTC
CGTTGGGCGGA -> GTTGGGCGGAG
CGTTTAAGCTA -> GTTTAAGCTAC
CGTTTTATGAA -> GTTTTATGAAT
CGTTTTGGGTC -> GTTTTGGGTCC
CTAACAGCCAC -> TAACAGCCACC
CTAACTGGGCA -> TAACTGGGCAG
CTAACTGGTTT -> TAACTGGTTTT
CTAAGCAAACG -> TAAGCAAACGA
CTAATAGCAGC -> TAATAGCAGCT
CTAATCGAAAG -> TAATCGAAAGT
CTACAAGACTT -> TACAAGACTTA
CTACAAGTCTA -> TACAAGTCTAA
CTACACGATTG -> TACACGATTGT
CTACATCGTAA -> TACATCGTAAT
CTACCCCTGTG -> TACCCCTGTGC
CTACCCGACGC -> TACCCGACGCT
CTACCTCCCGG -> TACCTCCCGGG
CTACGATAGCT -> TACGATAGCTC
CTACGCATGCT -> TACGCATGCTG
CTACGGTCCTG -> TACGGTCCTGG
CTACGGTCTCA -> TACGGTCTCAT
CTACTCCGGGG -> TACTCCGGGGT
CTACTGAACTC -> TACTGAACTCG
CTACTGCTTCC -> TACTGCTTCCT
CTAGAGCGATT -> TAGAGCGATTT
CTAGCACTGTG -> TAGCACTGTGA
CTAGCCCAGGA -> TAGCCCAGGAT
CTAGCCCGAAA -> TAGCCCGAAAT
CTAGGCATGTT -> TAGGCATGTTT
CTAGGCATTAT -> TAGGCATTATG
CTAGGGAATAT -> TAGGGAATATT
CTAGGGCCTGG -> TAGGGCCTGGC
CTAGTCTTTGT -> TAGTCTTTGTT
CTATAATCGGA -> TATAATCGGAT
CTATCACTCCT -> TATCACTCCTG
CTATCTGAATT -> TATCTGAATTC
CTATTGACATT -> TATTGACATTT
CTCAAACTAGC -> TCAAACTAGCA
CTCAAGTGCGT -> TCAAGTGCGTC
CTCACAAGTGG -> TCACAAGTGGT
CTCAGCGTCCT -> TCAGCGTCCTA
CTCATTGTCTT -> TCATTGTCTTA
CTCCACCGACT -> TCCACCGACTT
CTCCAGGCATC -> TCCAGGCATCC
CTCCCGGGATA -> TCCCGGGATAC
CTCCGGGGTAG -> TCCGGGGTAGG
CTCCTACGATA -> TCCTACGATAG
CTCCTCTGTCA -> TCCTCTGTCAT
CTCCTGAAGGT -> TCCTGAAGGTG
CTCCTGGAACG -> TCCTGGAACGC
CTCGAAATTAT -> TCGAAATTATC
CTCGATTCGGG -> TCGATTCGGGT
CTCGCAACACG -> TCGCAACACGC
CTCGCGTAGGT -> TCGCGTAGGTG
CTCGCTTACGT -> TCGCTTACGTG
CTCGGATGTCC -> TCGGATGTCCC
CTCGGCATCGG -> TCGGCATCGGT
CTCGGTCGCGA -> TCGGTCGCGAG
CTCGTAAAGCT -> TCGTAAAGCTC
CTCGTATAAAG -> TCGTATAAAGC
CTCGTATGGGG -> TCGTATGGGGG
CTCGTGGCGAT -> TCGTGGCGATT
CTCTACTGAAC -> TCTACTGAACT
CTCTAGCCCGA -> TCTAGCCCGAA
CTCTCGTAAAG -> TCTCGTAAAGC
CTCTGAGCTAC -> TCTGAGCTACT
CTCTGGGAATC -> TCTGGGAATCC
CTCTGTAGCCG -> TCTGTAGCCGT
CTCTGTCATTC -> TCTGTCATTCC
CTGAAAATTAG -> TGAAAATTAGT
CTGAACTCGGA -> TGAACTCGGAT
CTGAAGGTGTA -> TGAAGGTGTAC
CTGAATTCGTC -> TGAATTCGTCG
CTGACAATGTA -> TGACAATGTAG
CTGACATAACA -> TGACATAACAG
CTGAGATCACG -> TGAGATCACGC
CTGAGCTACTC -> TGAGCTACTCC
CTGATGAACAT -> TGATGAACATC
CTGATTAATGC -> TGATTAATGCC
CTGATTTTGGA -> TGATTTTGGAT
CTGCAATCCGC -> TGCAATCCGCA
CTGCATTTGCA -> TGCATTTGCAT
CTGCCAGGGGT -> TGCCAGGGGTA
CTGCCTGAGAT -> TGCCTGAGATC
CTGCGTTGGGC -> TGCGTTGGGCG
CTGCTCGTGGC -> TGCTCGTGGCG
CTGCTGTAGCT -> TGCTGTAGCTG
CTGCTTCCTCC -> TGCTTCCTCCA
CTGGAACGCGC -> TGGAACGCGCG
CTGGAAGCCCC -> TGGAAGCCCCG
CTGGATACGTA -> TGGATACGTAA
CTGGATCATTC -> TGGATCATTCT
CTGGATCTCTG -> TGGATCTCTGT
CTGGCCATATG -> TGGCCATATGT
CTGGGAATCCT -> TGGGAATCCTA
CTGGGCAGCGA -> TGGGCAGCGAC
CTGGGCTTCCG -> TGGGCTTCCGT
CTGGTTTTTCT -> TGGTTTTTCTG
CTGTAGCCGTG -> TGTAGCCGTGC
CTGTAGCTGCA -> TGTAGCTGCAA
CTGTCATTCCG -> TGTCATTCCGT
CTGTCGTAAGC -> TGTCGTAAGCT
CTGTGATCTCA -> TGTGATCTCAA
CTGTGCTCACA -> TGTGCTCACAA
CTGTGGACGCG -> TGTGGACGCGC
CTGTGTATAAC -> TGTGTATAACA
CTGTGTGCGAG -> TGTGTGCGAGG
CTTAAAGTCGG -> TTAAAGTCGGC
CTTAAGTCAGG -> TTAAGTCAGGA
CTTAATTAAAG -> TTAATTAAAGA
CTTACGGGAGG -> TTACGGGAGGG
CTTACGTGGTC -> TTACGTGGTCC
CTTAGCGGGGG -> TTAGCGGGGGC
CTTAGGGTTCG -> TTAGGGTTCGC
CTTATAGGGCA -> TTATAGGGCAG
CTTATCGCGTC -> TTATCGCGTCA
CTTCATAAAAT -> TTCATAAAATT
CTTCCGTAAAT -> TTCCGTAAATC
CTTCCTCCAGG -> TTCCTCCAGGC
CTTCGACGCGT -> TTCGACGCGTG
CTTCGCATCGT -> TTCGCATCGTG
CTTCGTGTCAT -> TTCGTGTCATT
CTTCTACGCAT -> TTCTACGCATG
CTTGTCCATGC -> TTGTCCATGCC
CTTTAGGGAAT -> TTTAGGGAATA
CTTTCGTTCCG -> TTTCGTTCCGG
CTTTGTTCTTC -> TTTGTTCTTCT
CTTTGTTTCGA -> TTTGTTTCGAT
CTTTTATCGAA -> TTTTATCGAAA
CTTTTGTATTT -> TTTTGTATTTT
CTTTTTGGGAA -> TTTTTGGGAAT
GAAAATACACG -> AAAATACACGC
GAAAATTAGTA -> AAAATTAGTAA
GAAACCATGAA -> AAACCATGAAG
GAAACGCTAGA -> AAACGCTAGAG
GAAACTTTGTT -> AAACTTTGTTC
GAAAGTACGGT -> AAAGTACGGTC
GAAAGTTCTTT -> AAAGTTCTTTT
GAAATCAGTAA -> AAATCAGTAAG
GAAATGCGGAA -> AAATGCGGAAT
GAAATTATCGA -> AAATTATCGAC
GAACATCGCTG -> AACATCGCTGC
GAACCGCCCTA -> AACCGCCCTAC
GAACCGTGATG -> AACCGTGATGA
GAACGCGCGAC -> AACGCGCGACC
GAACTCGGATG -> AACTCGGATGT
GAAGACATCTT -> AAGACATCTTT
GAAGACCCCAA -> AAGACCCCAAT
GAAGCCCCGTC -> AAGCCCCGTCG
GAAGCGACGGC -> AAGCGACGGCA
GAAGGGCGACT -> AAGGGCGACTA
GAAGGTGTACA -> AAGGTGTACAG
GAAGTCAGATA -> AAGTCAGATAA
GAATAAAACCA -> AATAAAACCAT
GAATAATGATC -> AATAATGATCG
GAATAGAATGC -> AATAGAATGCA
GAATATTCTGA -> AATATTCTGAC
GAATCTCGTAT -> AATCTCGTATG
GAATGCACTAC -> AATGCACTACG
GAATGTGAATA -> AATGTGAATAG
GAATTATAAGT -> AATTATAAGTC
GAATTCGTCGA -> AATTCGTCGAC
GAATTCGTTTT -> AATTCGTTTTA
GAATTCTAGCC -> AATTCTAGCCC
GAATTTAAGAG -> AATTTAAGAGC
GACAAGGATAC -> ACAAGGATACC
GACAATGTAGA -> ACAATGTAGAA
GACACCATCAT -> ACACCATCATA
GACACTAATAG -> ACACTAATAGC
GACAGCGCGAT -> ACAGCGCGATT
GACAGCTGCTC -> ACAGCTGCTCG
GACATAACAGG -> ACATAACAGGG
GACATAGAGAT -> ACATAGAGATG
GACATCTTTCG -> ACATCTTTCGT
GACATTTGAGA -> ACATTTGAGAA
GACCCCAATTG -> ACCCCAATTGA
GACCCCATAGA -> ACCCCATAGAT
GACCCCGTGCA -> ACCCCGTGCAA
GACCGCTCGCG -> ACCGCTCGCGT
GACCGGGCATG -> ACCGGGCATGT
GACCTCTAGCC -> ACCTCTAGCCC
GACGCAAGGCC -> ACGCAAGGCCT
GACGCCTACCT -> ACGCCTACCTC
GACGCCTTATA -> ACGCCTTATAG
GACGCGCGGAC -> ACGCGCGGACG
GACGCGCTCGG -> ACGCGCTCGGT
GACGCGTGCAG -> ACGCGTGCAGA
GACGCTTAAAG -> ACGCTTAAAGT
GACGGCATTAT -> ACGGCATTATT
GACGGTAGCAC -> ACGGTAGCACC
GACTAACTGGT -> ACTAACTGGTT
GACTAATCGAA -> ACTAATCGAAA
GACTAGGCATG -> ACTAGGCATGT
GACTATTGACA -> ACTATTGACAT
GACTCCTCTGT -> ACTCCTCTGTC
GACTGGATCTC -> ACTGGATCTCT
GACTTACGGGA -> ACTTACGGGAG
GACTTATCGCG -> ACTTATCGCGT
GAGAATTCTAG -> AGAATTCTAGC
GAGACACTAAT -> AGACACTAATA
GAGAGAGATGT -> AGAGAGATGTG
GAGAGATGTGA -> AGAGATGTGAA
GAGAGCATTCT -> AGAGCATTCTG
GAGATCACGCC -> AGATCACGCCT
GAGATGACAGC -> AGATGACAGCT
GAGATGTGAAA -> AGATGTGAAAA
GAGCAAGCAGT -> AGCAAGCAGTG
GAGCAGTCGTA -> AGCAGTCGTAG
GAGCATTCTGT -> AGCATTCTGTG
GAGCCAGGCAA -> AGCCAGGCAAG
GAGCCTGGATA -> AGCCTGGATAC
GAGCCTTCGAC -> AGCCTTCGACG
GAGCGATTTGT -> AGCGATTTGTG
GAGCGCTTCGC -> AGCGCTTCGCA
GAGCTACTCCG -> AGCTACTCCGG
GAGCTCTACTG -> AGCTCTACTGA
GAGGACTATTG -> AGGACTATTGA
GAGGCAGTCCA -> AGGCAGTCCAT
GAGGCGCAATA -> AGGCGCAATAA
GAGGGTGCTCA -> AGGGTGCTCAG
GAGTAAGTCAA -> AGTAAGTCAAG
GATAAGCGAGC -> ATAAGCGAGCA
GATAATAACTA -> ATAATAACTAC
GATACCTGATT -> ATACCTGATTT
GATACGTAAGC -> ATACGTAAGCT
GATACGTTAGC -> ATACGTTAGCG
GATACGTTTTG -> ATACGTTTTGG
GATACTACCCC -> ATACTACCCCT
GATAGAATTTA -> ATAGAATTTAA
GATAGCTCGTA -> ATAGCTCGTAT
GATAGGCTACG -> ATAGGCTACGG
GATATCGCCTG -> ATATCGCCTGC
GATATTCAGTT -> ATATTCAGTTC
GATCACGCCTG -> ATCACGCCTGG
GATCATTCTAA -> ATCATTCTAAG
GATCCAGTACT -> ATCCAGTACTG
GATCCATCGCC -> ATCCATCGCCA
GATCCCCACCA -> ATCCCCACCAA
GATCCTTTTGT -> ATCCTTTTGTA
GATCGCTCCAC -> ATCGCTCCACC
GATCGTCGCCC -> ATCGTCGCCCC
GATCTCAAGTG -> ATCTCAAGTGC
GATCTCTGTAG -> ATCTCTGTAGC
GATCTTTTATC -> ATCTTTTATCG
GATGAACATCG -> ATGAACATCGC
GATGAAGTCAG -> ATGAAGTCAGA
GATGACAGCTG -> ATGACAGCTGC
GATGAGCAAGC -> ATGAGCAAGCA
GATGCGCCCGA -> ATGCGCCCGAT
GATGTCCCACG -> ATGTCCCACGT
GATGTGAAAAT -> ATGTGAAAATA
GATTAATGCCT -> ATTAATGCCTT
GATTACGGTAT -> ATTACGGTATA
GATTAGAACCG -> ATTAGAACCGT
GATTATGCAAC -> ATTATGCAACT
GATTCAGATTC -> ATTCAGATTCC
GATTCCTTAGG -> ATTCCTTAGGG
GATTCGGGTAG -> ATTCGGGTAGT
GATTCTAACTG -> ATTCTAACTGG
GATTGGTCCCG -> ATTGGTCCCGC
GATTGTATGCT -> ATTGTATGCTC
GATTGTGCCCT -> ATTGTGCCCTG
GATTTGTGTGA -> ATTTGTGTGAG
GATTTTGGATA -> ATTTTGGATAG
GCAAACGAGAG -> CAAACGAGAGC
GCAAAGACAGC -> CAAAGACAGCG
GCAAATTAGCC -> CAAATTAGCCT
GCAACACGCAT -> CAACACGCATT
GCAACTTTAGG -> CAACTTTAGGG
GCAAGCAGTGG -> CAAGCAGTGGA
GCAAGCTTCGT -> CAAGCTTCGTG
GCAAGGCCTGA -> CAAGGCCTGAT
GCAATAACTAC -> CAATAACTACA
GCAATCCGCAA -> CAATCCGCAAA
GCACCGCATTA -> CACCGCATTAG
GCACCGGAGGC -> CACCGGAGGCG
GCACGACGCGC -> CACGACGCGCG
GCACTACGGTC -> CACTACGGTCC
GCACTATAATC -> CACTATAATCG
GCACTGTGATC -> CACTGTGATCT
GCAGATACGTT -> CAGATACGTTA,CAGATACGTTT
GCAGCGAAACG -> CAGCGAAACGC
GCAGCGACTGG -> CAGCGACTGGA
GCAGCTCCTAC -> CAGCTCCTACG
GCAGTCCATCT -> CAGTCCATCTC
GCAGTCGTAGA -> CAGTCGTAGAA
GCAGTGGAAGA -> CAGTGGAAGAC
GCATCCTGACA -> CATCCTGACAT
GCATCGGTATC -> CATCGGTATCA
GCATCGTGGAC -> CATCGTGGACG
GCATGCTGGAA -> CATGCTGGAAG
GCATGTCATAT -> CATGTCATATG
GCATGTTTTCT -> CATGTTTTCTA
GCATTAGATAT -> CATTAGATATT
GCATTAGCTAG -> CATTAGCTAGG
GCATTATGAAT -> CATTATGAATT
GCATTATTTGA -> CATTATTTGAC
GCATTCTGTGT -> CATTCTGTGTG
GCATTGACCCC -> CATTGACCCCA
GCATTTGCATT -> CATTTGCATTA
GCCAACTCCTG -> CCAACTCCTGA
GCCAATCCGCC -> CCAATCCGCCT
GCCACAGTATC -> CCACAGTATCT
GCCACCGACGC -> CCACCGACGCC
GCCAGGCAAGC -> CCAGGCAAGCT
GCCAGGGGTAA -> CCAGGGGTAAC
GCCATATGTGT -> CCATATGTGTA
GCCCAGGATTA -> CCCAGGATTAT
GCCCCCGACGC -> CCCCCGACGCC
GCCCCGTCGGG -> CCCCGTCGGGA
GCCCGAAATCA -> CCCGAAATCAG
GCCCGATCGCT -> CCCGATCGCTC
GCCCTACCCGA -> CCCTACCCGAC
GCCCTGTGGAC -> CCCTGTGGACG
GCCGCGGTCCG -> CCGCGGTCCGA
GCCGTGCACTA -> CCGTGCACTAT
GCCTACCTCCC -> CCTACCTCCCG
GCCTACTGCTT -> CCTACTGCTTC
GCCTCTCGTAA -> CCTCTCGTAAA
GCCTGAGATCA -> CCTGAGATCAC
GCCTGATTAAT -> CCTGATTAATG
GCCTGCCTGAG -> CCTGCCTGAGA
GCCTGGATACG -> CCTGGATACGT
GCCTGGATCAT -> CCTGGATCATT
GCCTGGCCATA -> CCTGGCCATAT
GCCTGTCGTAA -> CCTGTCGTAAG
GCCTTATAGGG -> CCTTATAGGGC
GCCTTCATAAA -> CCTTCATAAAA
GCCTTCGACGC -> CCTTCGACGCG
GCCTTGTCCAT -> CCTTGTCCATG
GCGAAACGCTA -> CGAAACGCTAG
GCGAAGACCCC -> CGAAGACCCCA
GCGACCTCTAG -> CGACCTCTAGC
GCGACGGCATT -> CGACGGCATTA
GCGACTAACTG -> CGACTAACTGG
GCGACTGGATC -> CGACTGGATCT
GCGAGCAGTCG -> CGAGCAGTCGT
GCGAGCGCTTC -> CGAGCGCTTCG
GCGAGCTCTAC -> CGAGCTCTACT
GCGAGGACTAT -> CGAGGACTATT
GCGATCCTTTT -> CGATCCTTTTG
GCGATTACGGT -> CGATTACGGTA
GCGATTAGAAC -> CGATTAGAACC
GCGATTTGTGT -> CGATTTGTGTG
GCGCAATAACT -> CGCAATAACTA
GCGCACCGGAG -> CGCACCGGAGG
GCGCCCGATCG -> CGCCCGATCGC
GCGCGACCTCT -> CGCGACCTCTA
GCGCGATCCTT -> CGCGATCCTTT
GCGCGATTACG -> CGCGATTACGG
GCGCGCACCGG -> CGCGCACCGGA
GCGCGGACGGT -> CGCGGACGGTA
GCGCTCGGTCG -> CGCTCGGTCGC
GCGCTTCGCAT -> CGCTTCGCATC
GCGGAATCTCG -> CGGAATCTCGT
GCGGACGGTAG -> CGGACGGTAGC
GCGGAGCCTTC -> CGGAGCCTTCG
GCGGATCCAGT -> CGGATCCAGTA
GCGGGGGCCGC -> CGGGGGCCGCG
GCGGTCCGATT -> CGGTCCGATTC
GCGGTCTCGAA -> CGGTCTCGAAA
GCGTAGGTGCG -> CGTAGGTGCGG
GCGTCAAGTTT -> CGTCAAGTTTC
GCGTCCTATCA -> CGTCCTATCAC
GCGTCGATAGA -> CGTCGATAGAA
GCGTGCAGATA -> CGTGCAGATAC
GCGTTGGGCGG -> CGTTGGGCGGA
GCTACATCGTA -> CTACATCGTAA
GCTACGGTCTC -> CTACGGTCTCA
GCTACTCCGGG -> CTACTCCGGGG
GCTAGAGCGAT -> CTAGAGCGATT
GCTAGGGAATA -> CTAGGGAATAT
GCTAGTCTTTG -> CTAGTCTTTGT
GCTCAAACTAG -> CTCAAACTAGC
GCTCACAAGTG -> CTCACAAGTGG
GCTCAGCGTCC -> CTCAGCGTCCT
GCTCCACCGAC -> CTCCACCGACT
GCTCCTACGAT -> CTCCTACGATA
GCTCGCGTAGG -> CTCGCGTAGGT
GCTCGGCATCG -> CTCGGCATCGG
GCTCGGTCGCG -> CTCGGTCGCGA
GCTCGTATAAA -> CTCGTATAAAG
GCTCGTGGCGA -> CTCGTGGCGAT
GCTCTACTGAA -> CTCTACTGAAC
GCTCTGAGCTA -> CTCTGAGCTAC
GCTGAAAATTA -> CTGAAAATTAG
GCTGCAATCCG -> CTGCAATCCGC
GCTGCATTTGC -> CTGCATTTGCA
GCTGCTCGTGG -> CTGCTCGTGGC
GCTGCTGTAGC -> CTGCTGTAGCT
GCTGGAAGCCC -> CTGGAAGCCCC
GCTGTAGCTGC -> CTGTAGCTGCA
GCTTAAAGTCG -> CTTAAAGTCGG
GCTTAAGTCAG -> CTTAAGTCAGG
GCTTACGTGGT -> CTTACGTGGTC
GCTTCCGTAAA -> CTTCCGTAAAT
GCTTCCTCCAG -> CTTCCTCCAGG
GCTTCGCATCG -> CTTCGCATCGT
GCTTCGTGTCA -> CTTCGTGTCAT
GGAAACTTTGT -> GAAACTTTGTT
GGAACGCGCGA -> GAACGCGCGAC
GGAAGACATCT -> GAAGACATCTT
GGAAGCCCCGT -> GAAGCCCCGTC
GGAAGCGACGG -> GAAGCGACGGC
GGAATAAAACC -> GAATAAAACCA
GGAATAATGAT -> GAATAATGATC
GGAATATTCTG -> GAATATTCTGA
GGAATCTCGTA -> GAATCTCGTAT
GGACCCCGTGC -> GACCCCGTGCA
GGACGCAAGGC -> GACGCAAGGCC
GGACGCGCTCG -> GACGCGCTCGG
GGACGGTAGCA -> GACGGTAGCAC
GGACTATTGAC -> GACTATTGACA
GGACTCCTCTG -> GACTCCTCTGT
GGAGAGAGATG -> GAGAGAGATGT
GGAGCCTTCGA -> GAGCCTTCGAC
GGAGGCGCAAT -> GAGGCGCAATA
GGAGGGTGCTC -> GAGGGTGCTCA
GGATACCTGAT -> GATACCTGATT
GGATACGTAAG -> GATACGTAAGC
GGATACTACCC -> GATACTACCCC
GGATAGGCTAC -> GATAGGCTACG
GGATATCGCCT -> GATATCGCCTG
GGATCATTCTA -> GATCATTCTAA
GGATCCAGTAC -> GATCCAGTACT
GGATCCATCGC -> GATCCATCGCC
GGATCTCTGTA -> GATCTCTGTAG
GGATGTCCCAC -> GATGTCCCACG
GGATTATGCAA -> GATTATGCAAC
GGATTGTGCCC -> GATTGTGCCCT
GGCAAGCTTCG -> GCAAGCTTCGT
GGCACGACGCG -> GCACGACGCGC
GGCAGCGAAAC -> GCAGCGAAACG
GGCAGCGACTG -> GCAGCGACTGG
GGCAGTCCATC -> GCAGTCCATCT
GGCATCCTGAC -> GCATCCTGACA
GGCATCGGTAT -> GCATCGGTATC
GGCATGTCATA -> GCATGTCATAT
GGCATGTTTTC -> GCATGTTTTCT
GGCATTATGAA -> GCATTATGAAT
GGCATTATTTG -> GCATTATTTGA
GGCCAACTCCT -> GCCAACTCCTG
GGCCATATGTG -> GCCATATGTGT
GGCCGCGGTCC -> GCCGCGGTCCG
GGCCTGATTAA -> GCCTGATTAAT
GGCCTGGCCAT -> GCCTGGCCATA
GGCGACTAACT -> GCGACTAACTG
GGCGATTAGAA -> GCGATTAGAAC
GGCGCAATAAC -> GCGCAATAACT
GGCGCGATCCT -> GCGCGATCCTT
GGCGCGCACCG -> GCGCGCACCGG
GGCGGAGCCTT -> GCGGAGCCTTC
GGCTACGGTCT -> GCTACGGTCTC
GGCTTAAGTCA -> GCTTAAGTCAG
GGCTTCCGTAA -> GCTTCCGTAAA
GGGAAACTTTG -> GGAAACTTTGT
GGGAAGCGACG -> GGAAGCGACGG
GGGAATAAAAC -> GGAATAAAACC
GGGAATAATGA -> GGAATAATGAT
GGGAATATTCT -> GGAATATTCTG
GGGAGGGTGCT -> GGAGGGTGCTC
GGGATACTACC -> GGATACTACCC
GGGATTGTGCC -> GGATTGTGCCC
GGGCACGACGC -> GGCACGACGCG
GGGCAGCGAAA -> GGCAGCGAAAC
GGGCAGCGACT -> GGCAGCGACTG
GGGCATGTCAT -> GGCATGTCATA
GGGCCGCGGTC -> GGCCGCGGTCC
GGGCCTGGCCA -> GGCCTGGCCAT
GGGCGACTAAC -> GGCGACTAACT
GGGCGGAGCCT -> GGCGGAGCCTT
GGGCTTCCGTA -> GGCTTCCGTAA
GGGGATTGTGC -> GGGATTGTGCC
GGGGCCGCGGT -> GGGCCGCGGTC
GGGGGATTGTG -> GGGGATTGTGC
GGGGGCCGCGG -> GGGGCCGCGGT
GGGGGGATTGT -> GGGGGATTGTG
GGGGTAACCAA -> GGGTAACCAAC
GGGGTAGGATA -> GGGTAGGATAT
GGGTAACCAAC -> GGTAACCAACT
GGGTAGGATAT -> GGTAGGATATC
GGGTAGTCCCA -> GGTAGTCCCAT
GGGTCCGCCAC -> GGTCCGCCACA
GGGTGCTCAGC -> GGTGCTCAGCG
GGGTGTCTGCG -> GGTGTCTGCGT
GGGTTCGCAGA -> GGTTCGCAGAT
GGTAACCAACT -> GTAACCAACTC
GGTACACCCGA -> GTACACCCGAT
GGTAGCACCGC -> GTAGCACCGCA
GGTAGGATATC -> GTAGGATATCG
GGTAGTCCCAT -> GTAGTCCCATC
GGTATAGAGGC -> GTATAGAGGCA
GGTATCAAGTC -> GTATCAAGTCA
GGTCCCAGTTG -> GTCCCAGTTGA
GGTCCCGCTAG -> GTCCCGCTAGT
GGTCCCTGCCA -> GTCCCTGCCAG
GGTCCGATTCA -> GTCCGATTCAG
GGTCCGCCACA -> GTCCGCCACAG
GGTCCTGGGCT -> GTCCTGGGCTT
GGTCGCGAGCG -> GTCGCGAGCGC
GGTCTCATTGT -> GTCTCATTGTC
GGTCTCGAAAT -> GTCTCGAAATT
GGTGACAAGGA -> GTGACAAGGAT
GGTGCGGTCTC -> GTGCGGTCTCG
GGTGCTCAGCG -> GTGCTCAGCGT
GGTGTACAGAC -> GTGTACAGACT
GGTGTCTGCGT -> GTGTCTGCGTT
GGTTCGCAGAT -> GTTCGCAGATA
GGTTTTTCTGT -> GTTTTTCTGTG
GTAAAGCTCTG -> TAAAGCTCTGA
GTAAATCTAGG -> TAAATCTAGGC
GTAACCAACTC -> TAACCAACTCT
GTAACGTTGAT -> TAACGTTGATT
GTAAGACACCA -> TAAGACACCAT
GTAAGCTCAAA -> TAAGCTCAAAC
GTAAGCTGCAT -> TAAGCTGCATT
GTAAGGCTTAA -> TAAGGCTTAAG
GTAAGTCAAGC -> TAAGTCAAGCT
GTAATATCGAC -> TAATATCGACC
GTAATGTCCGT -> TAATGTCCGTA
GTACACCCGAT -> TACACCCGATG
GTACAGACTAG -> TACAGACTAGG
GTACGGTCCCT -> TACGGTCCCTG
GTACTGATGAA -> TACTGATGAAC
GTAGAAAGTTC -> TAGAAAGTTCT
GTAGAATTCGT -> TAGAATTCGTT
GTAGCACCGCA -> TAGCACCGCAT
GTAGCCGTGCA -> TAGCCGTGCAC
GTAGCTGCAAT -> TAGCTGCAATC
GTAGGACTCCT -> TAGGACTCCTC
GTAGGATATCG -> TAGGATATCGC
GTAGGGAAACT -> TAGGGAAACTT
GTAGGTGCGGT -> TAGGTGCGGTC
GTAGTAACGTT -> TAGTAACGTTG
GTAGTCCCATC -> TAGTCCCATCA
GTATAAAGCCT -> TATAAAGCCTT
GTATAACAAGA -> TATAACAAGAT
GTATAGAGGCA -> TATAGAGGCAG
GTATCAAGTCA -> TATCAAGTCAT
GTATCTAGGGC -> TATCTAGGGCC
GTATGCTCGGC -> TATGCTCGGCA
GTATGGGGGGA -> TATGGGGGGAT
GTATTTTTTGA -> TATTTTTTGAG
GTCAAGCTGAA -> TCAAGCTGAAA
GTCAAGTTTCA -> TCAAGTTTCAA
GTCAGATAAGC -> TCAGATAAGCG
GTCAGGAGAGA -> TCAGGAGAGAG
GTCATATGCGA -> TCATATGCGAA
GTCATCCGTGT -> TCATCCGTGTT
GTCATTCCGTT -> TCATTCCGTTT
GTCATTGAACC -> TCATTGAACCG
GTCCATCTCGA -> TCCATCTCGAT
GTCCATGCCTC -> TCCATGCCTCT
GTCCCACGTCC -> TCCCACGTCCG
GTCCCAGTTGA -> TCCCAGTTGAG
GTCCCATCAGG -> TCCCATCAGGT
GTCCCGCTAGT -> TCCCGCTAGTC
GTCCCTGCCAG -> TCCCTGCCAGG
GTCCGATTCAG -> TCCGATTCAGA
GTCCGCCACAG -> TCCGCCACAGT
GTCCGGCCAAC -> TCCGGCCAACT
GTCCGTAGGGA -> TCCGTAGGGAA
GTCCTATCACT -> TCCTATCACTC
GTCCTGGGCTT -> TCCTGGGCTTC
GTCGACTAATC -> TCGACTAATCG
GTCGATAGAAT -> TCGATAGAATT
GTCGCCCCCGA -> TCGCCCCCGAC
GTCGCGAGCGC -> TCGCGAGCGCT
GTCGGCGCGAT -> TCGGCGCGATC
GTCGGGAAGCG -> TCGGGAAGCGA
GTCGTAAGCTG -> TCGTAAGCTGC
GTCGTAGAAAG -> TCGTAGAAAGT
GTCTAACAGCC -> TCTAACAGCCA
GTCTCATTGTC -> TCTCATTGTCT
GTCTCGAAATT -> TCTCGAAATTA
GTCTCGCTTAC -> TCTCGCTTACG
GTCTGCGTTGG -> TCTGCGTTGGG
GTCTTAATTAA -> TCTTAATTAAA
GTCTTTGTTTC -> TCTTTGTTTCG
GTGAAAATACA -> TGAAAATACAC
GTGAATAGAAT -> TGAATAGAATG
GTGACAAGGAT -> TGACAAGGATA
GTGAGACACTA -> TGAGACACTAA
GTGATCTCAAG -> TGATCTCAAGT
GTGATGAAGTC -> TGATGAAGTCA
GTGCAAATTAG -> TGCAAATTAGC
GTGCACTATAA -> TGCACTATAAT
GTGCAGATACG -> TGCAGATACGT
GTGCCCTGTGG -> TGCCCTGTGGA
GTGCGAGGACT -> TGCGAGGACTA
GTGCGGTCTCG -> TGCGGTCTCGA
GTGCGTCGATA -> TGCGTCGATAG
GTGCTCACAAG -> TGCTCACAAGT
GTGCTCAGCGT -> TGCTCAGCGTC
GTGGAAGACAT -> TGGAAGACATC
GTGGACGCAAG -> TGGACGCAAGG
GTGGACGCGCT -> TGGACGCGCTC
GTGGCGATTAG -> TGGCGATTAGA
GTGGTACACCC -> TGGTACACCCG
GTGGTCCCAGT -> TGGTCCCAGTT
GTGTACAGACT -> TGTACAGACTA
GTGTAGGACTC -> TGTAGGACTCC
GTGTATAACAA -> TGTATAACAAG
GTGTCATTGAA -> TGTCATTGAAC
GTGTCTGCGTT -> TGTCTGCGTTG
GTGTGAGACAC -> TGTGAGACACT
GTGTGCGAGGA -> TGTGCGAGGAC
GTGTTAAGGCG -> TGTTAAGGCGC
GTTAAGGCGCG -> TTAAGGCGCGC
GTTAGCGGATC -> TTAGCGGATCC
GTTCCGGGCAC -> TTCCGGGCACG
GTTCCTATCTG -> TTCCTATCTGA
GTTCGCAGATA -> TTCGCAGATAC
GTTCTTCTACG -> TTCTTCTACGC
GTTCTTTTTGG -> TTCTTTTTGGG
GTTGAGCCTGG -> TTGAGCCTGGA
GTTGATTGGTC -> TTGATTGGTCC
GTTGGGCGGAG -> TTGGGCGGAGC
GTTTAAGCTAC -> TTTAAGCTACA
GTTTCAACCAC -> TTTCAACCACA
GTTTCGATCTT -> TTTCGATCTTT
GTTTTATGAAT -> TTTTATGAATG
GTTTTCTACAC -> TTTTCTACACG
GTTTTGGGTCC -> TTTTGGGTCCG
GTTTTTCTGTG -> TTTTTCTGTGT
TAAAACCATGG -> AAAACCATGGA
TAAAATTCTTA -> AAAATTCTTAG
TAAAGATAATA -> AAAGATAATAA
TAAAGCCTTCA -> AAAGCCTTCAT
TAAAGCTCTGA -> AAAGCTCTGAG
TAAAGTCGGCG -> AAAGTCGGCGC
TAAATCTAGGC -> AAATCTAGGCA
TAACAAGATTC -> AACAAGATTCT
TAACAGCCACC -> AACAGCCACCG
TAACAGGGTGT -> AACAGGGTGTC
TAACCAACTCT -> AACCAACTCTG
TAACGTTGATT -> AACGTTGATTG
TAACTACAAGA -> AACTACAAGAC
TAACTACAAGT -> AACTACAAGTC
TAACTGGGCAG -> AACTGGGCAGC
TAACTGGTTTT -> AACTGGTTTTT
TAAGACACCAT -> AAGACACCATC
TAAGAGCCAGG -> AAGAGCCAGGC
TAAGCAAACGA -> AAGCAAACGAG
TAAGCGAGCAG -> AAGCGAGCAGT
TAAGCTACATC -> AAGCTACATCG
TAAGCTCAAAC -> AAGCTCAAACT
TAAGCTGCATT -> AAGCTGCATTT
TAAGGCGCGCA -> AAGGCGCGCAC
TAAGGCTTAAG -> AAGGCTTAAGT
TAAGTCAAGCT -> AAGTCAAGCTG
TAAGTCAGGAG -> AAGTCAGGAGA
TAAGTCTCGCT -> AAGTCTCGCTT
TAATAACTACA -> AATAACTACAA
TAATAGCAGCT -> AATAGCAGCTC
TAATATCGACC -> AATATCGACCG
TAATCGAAAGT -> AATCGAAAGTA
TAATCGGATCC -> AATCGGATCCA
TAATGATCGTC -> AATGATCGTCG
TAATGCCTTGT -> AATGCCTTGTC
TAATGTCCGTA -> AATGTCCGTAG
TAATTAAAGAT -> AATTAAAGATA
TACAAGACTTA -> ACAAGACTTAT
TACAAGTCTAA -> ACAAGTCTAAC
TACACCCGATG -> ACACCCGATGC
TACACGATTGT -> ACACGATTGTA
TACACGCGAGC -> ACACGCGAGCT
TACAGACTAGG -> ACAGACTAGGC
TACATCGTAAT -> ACATCGTAATG
TACCCCTGTGC -> ACCCCTGTGCT
TACCCGACGCT -> ACCCGACGCTT
TACCTCCCGGG -> ACCTCCCGGGA
TACCTGATTTT -> ACCTGATTTTG
TACGATAGCTC -> ACGATAGCTCG
TACGCATGCTG -> ACGCATGCTGG
TACGGGAGGGT -> ACGGGAGGGTG
TACGGTATAGA -> ACGGTATAGAG
TACGGTCCCTG -> ACGGTCCCTGC
TACGGTCCTGG -> ACGGTCCTGGG
TACGGTCTCAT -> ACGGTCTCATT
TACGTAAGCTC -> ACGTAAGCTCA
TACGTGGTCCC -> ACGTGGTCCCA
TACGTTAGCGG -> ACGTTAGCGGA
TACGTTTTGGG -> ACGTTTTGGGT
TACTACCCCTG -> ACTACCCCTGT
TACTCCGGGGT -> ACTCCGGGGTA
TACTGAACTCG -> ACTGAACTCGG
TACTGATGAAC -> ACTGATGAACA
TACTGCTTCCT -> ACTGCTTCCTC
TAGAAAGTTCT -> AGAAAGTTCTT
TAGAACCGTGA -> AGAACCGTGAT
TAGAATGCACT -> AGAATGCACTA
TAGAATTCGTT -> AGAATTCGTTT
TAGAATTTAAG -> AGAATTTAAGA
TAGAGATGACA -> AGAGATGACAG
TAGAGCGATTT -> AGAGCGATTTG
TAGAGGCAGTC -> AGAGGCAGTCC
TAGATATTCAG -> AGATATTCAGT
TAGATCCCCAC -> AGATCCCCACC
TAGCACCGCAT -> AGCACCGCATT
TAGCACTGTGA -> AGCACTGTGAT
TAGCAGCTCCT -> AGCAGCTCCTA
TAGCCCAGGAT -> AGCCCAGGATT
TAGCCCGAAAT -> AGCCCGAAATC
TAGCCGTGCAC -> AGCCGTGCACT
TAGCCTGTCGT -> AGCCTGTCGTA
TAGCGGATCCA -> AGCGGATCCAG
TAGCGGGGGCC -> AGCGGGGGCCG
TAGCTAGGGAA -> AGCTAGGGAAT
TAGCTCGTATA -> AGCTCGTATAA
TAGCTGCAATC -> AGCTGCAATCC
TAGGACTCCTC -> AGGACTCCTCT
TAGGATATCGC -> AGGATATCGCC
TAGGCATGTTT -> AGGCATGTTTT
TAGGCATTATG -> AGGCATTATGA
TAGGCTACGGT -> AGGCTACGGTC
TAGGGAAACTT -> AGGGAAACTTT
TAGGGAATAAT -> AGGGAATAATG
TAGGGAATATT -> AGGGAATATTC
TAGGGCAGCGA -> AGGGCAGCGAA
TAGGGCCTGGC -> AGGGCCTGGCC
TAGGGTTCGCA -> AGGGTTCGCAG
TAGGTGCGGTC -> AGGTGCGGTCT
TAGTAACGTTG -> AGTAACGTTGA
TAGTAATATCG -> AGTAATATCGA
TAGTAGTAACG -> AGTAGTAACGT
TAGTCCCATCA -> AGTCCCATCAG
TAGTCTTTGTT -> AGTCTTTGTTT
TATAAAGCCTT -> ATAAAGCCTTC
TATAACAAGAT -> ATAACAAGATT
TATAAGTCTCG -> ATAAGTCTCGC
TATAATCGGAT -> ATAATCGGATC
TATAGAGGCAG -> ATAGAGGCAGT
TATAGGGCAGC -> ATAGGGCAGCG
TATCAAGTCAT -> ATCAAGTCATC
TATCACTCCTG -> ATCACTCCTGG
TATCGAAACCA -> ATCGAAACCAT
TATCGACCGCT -> ATCGACCGCTC
TATCGACCGGG -> ATCGACCGGGC
TATCGCCTGCC -> ATCGCCTGCCT
TATCGCGTCAA -> ATCGCGTCAAG
TATCTAGGGCC -> ATCTAGGGCCT
TATCTGAATTC -> ATCTGAATTCG
TATGAATGTGA -> ATGAATGTGAA
TATGAATTATA -> ATGAATTATAA
TATGCAACTTT -> ATGCAACTTTA
TATGCGAAGAC -> ATGCGAAGACC
TATGCTCGGCA -> ATGCTCGGCAT
TATGGGGGGAT -> ATGGGGGGATT
TATGTGTAGGA -> ATGTGTAGGAC
TATTCAGTTCC -> ATTCAGTTCCT
TATTCTGACAA -> ATTCTGACAAT
TATTGACATTT -> ATTGACATTTG
TATTTGACATA -> ATTTGACATAG
TATTTTTTGAG -> ATTTTTTGAGT
TCAAACTAGCA -> CAAACTAGCAC
TCAACCACAAC -> CAACCACAACG
TCAAGCTGAAA -> CAAGCTGAAAA
TCAAGTCATCC -> CAAGTCATCCG
TCAAGTGCGTC -> CAAGTGCGTCG
TCAAGTTTCAA -> CAAGTTTCAAC
TCACAAGTGGT -> CACAAGTGGTA
TCACGCCTGGA -> CACGCCTGGAT
TCACTCCTGGA -> CACTCCTGGAA
TCAGATAAGCG -> CAGATAAGCGA
TCAGATTCCTT -> CAGATTCCTTA
TCAGCGTCCTA -> CAGCGTCCTAT
TCAGGAGAGAG -> CAGGAGAGAGA
TCAGGTGACAA -> CAGGTGACAAG
TCAGTAAGGCT -> CAGTAAGGCTT
TCAGTTCCTAT -> CAGTTCCTATC
TCATAAAATTC -> CATAAAATTCT
TCATAGTAGTA -> CATAGTAGTAA
TCATATGCGAA -> CATATGCGAAG
TCATCCGTGTT -> CATCCGTGTTA
TCATTCCGTTT -> CATTCCGTTTA
TCATTCTAAGC -> CATTCTAAGCA
TCATTGAACCG -> CATTGAACCGC
TCATTGTCTTA -> CATTGTCTTAA
TCCACCGACTT -> CCACCGACTTA
TCCAGGCATCC -> CCAGGCATCCT
TCCAGTACTGA -> CCAGTACTGAT
TCCATCGCCAA -> CCATCGCCAAT
TCCATCTCGAT -> CCATCTCGATT
TCCATGCCTCT -> CCATGCCTCTC
TCCCACGTCCG -> CCCACGTCCGG
TCCCAGTTGAG -> CCCAGTTGAGC
TCCCATCAGGT -> CCCATCAGGTG
TCCCCACCAAT -> CCCCACCAATG
TCCCGCTAGTC -> CCCGCTAGTCT
TCCCGGGATAC -> CCCGGGATACT
TCCCTGCCAGG -> CCCTGCCAGGG
TCCGATTCAGA -> CCGATTCAGAT
TCCGCAAAGAC -> CCGCAAAGACA
TCCGCCACAGT -> CCGCCACAGTA
TCCGCCTACTG -> CCGCCTACTGC
TCCGGCCAACT -> CCGGCCAACTC
TCCGGGCACGA -> CCGGGCACGAC
TCCGGGGTAGG -> CCGGGGTAGGA
TCCGTAAATCT -> CCGTAAATCTA
TCCGTAGGGAA -> CCGTAGGGAAA
TCCGTGTTAAG -> CCGTGTTAAGG
TCCGTTTAAGC -> CCGTTTAAGCT
TCCTACGATAG -> CCTACGATAGC
TCCTATCACTC -> CCTATCACTCC
TCCTATCTGAA -> CCTATCTGAAT
TCCTCCAGGCA -> CCTCCAGGCAT
TCCTCTGTCAT -> CCTCTGTCATT
TCCTGAAGGTG -> CCTGAAGGTGT
TCCTGACATAA -> CCTGACATAAC
TCCTGGAACGC -> CCTGGAACGCG
TCCTGGGCTTC -> CCTGGGCTTCC
TCCTTAGGGTT -> CCTTAGGGTTC
TCCTTTTGTAT -> CCTTTTGTATT
TCGAAACCATG -> CGAAACCATGA
TCGAAAGTACG -> CGAAAGTACGG
TCGAAATTATC -> CGAAATTATCG
TCGACCGCTCG -> CGACCGCTCGC
TCGACCGGGCA -> CGACCGGGCAT
TCGACGCGTGC -> CGACGCGTGCA
TCGACTAATCG -> CGACTAATCGA
TCGATAGAATT -> CGATAGAATTT
TCGATCTTTTA -> CGATCTTTTAT
TCGATTCGGGT -> CGATTCGGGTA
TCGCAACACGC -> CGCAACACGCA
TCGCAGATACG -> CGCAGATACGT
TCGCATCGTGG -> CGCATCGTGGA
TCGCCAATCCG -> CGCCAATCCGC
TCGCCCCCGAC -> CGCCCCCGACG
TCGCCTGCCTG -> CGCCTGCCTGA
TCGCGAGCGCT -> CGCGAGCGCTT
TCGCGTAGGTG -> CGCGTAGGTGC
TCGCGTCAAGT -> CGCGTCAAGTT
TCGCTCCACCG -> CGCTCCACCGA
TCGCTGCTGTA -> CGCTGCTGTAG
TCGCTTACGTG -> CGCTTACGTGG
TCGGATCCATC -> CGGATCCATCG
TCGGATGTCCC -> CGGATGTCCCA
TCGGCATCGGT -> CGGCATCGGTA
TCGGCGCGATC -> CGGCGCGATCC
TCGGGAAGCGA -> CGGGAAGCGAC
TCGGGTAGTCC -> CGGGTAGTCCC
TCGGTATCAAG -> CGGTATCAAGT
TCGGTCGCGAG -> CGGTCGCGAGC
TCGTAAAGCTC -> CGTAAAGCTCT
TCGTAAGCTGC -> CGTAAGCTGCA
TCGTAATGTCC -> CGTAATGTCCG
TCGTAGAAAGT -> CGTAGAAAGTT
TCGTATAAAGC -> CGTATAAAGCC
TCGTATGGGGG -> CGTATGGGGGG
TCGTCGACTAA -> CGTCGACTAAT
TCGTCGCCCCC -> CGTCGCCCCCG
TCGTGGACGCA -> CGTGGACGCAA
TCGTGGCGATT -> CGTGGCGATTA
TCGTGTCATTG -> CGTGTCATTGA
TCGTTCCGGGC -> CGTTCCGGGCA
TCGTTTTATGA -> CGTTTTATGAA
TCTAACAGCCA -> CTAACAGCCAC
TCTAACTGGGC -> CTAACTGGGCA
TCTAAGCAAAC -> CTAAGCAAACG
TCTACACGATT -> CTACACGATTG
TCTACGCATGC -> CTACGCATGCT
TCTACTGAACT -> CTACTGAACTC
TCTAGCCCAGG -> CTAGCCCAGGA
TCTAGCCCGAA -> CTAGCCCGAAA
TCTAGGCATTA -> CTAGGCATTAT
TCTAGGGCCTG -> CTAGGGCCTGG
TCTCAAGTGCG -> CTCAAGTGCGT
TCTCATTGTCT -> CTCATTGTCTT
TCTCGAAATTA -> CTCGAAATTAT
TCTCGATTCGG -> CTCGATTCGGG
TCTCGCTTACG -> CTCGCTTACGT
TCTCGTAAAGC -> CTCGTAAAGCT
TCTCGTATGGG -> CTCGTATGGGG
TCTCTGTAGCC -> CTCTGTAGCCG
TCTGAATTCGT -> CTGAATTCGTC
TCTGACAATGT -> CTGACAATGTA
TCTGAGCTACT -> CTGAGCTACTC
TCTGCGTTGGG -> CTGCGTTGGGC
TCTGGGAATCC -> CTGGGAATCCT
TCTGTAGCCGT -> CTGTAGCCGTG
TCTGTCATTCC -> CTGTCATTCCG
TCTGTGTATAA -> CTGTGTATAAC
TCTGTGTGCGA -> CTGTGTGCGAG
TCTTAATTAAA -> CTTAATTAAAG
TCTTAGCGGGG -> CTTAGCGGGGG
TCTTCTACGCA -> CTTCTACGCAT
TCTTTCGTTCC -> CTTTCGTTCCG
TCTTTGTTTCG -> CTTTGTTTCGA
TCTTTTATCGA -> CTTTTATCGAA
TCTTTTTGGGA -> CTTTTTGGGAA
TGAAAATACAC -> GAAAATACACG
TGAAAATTAGT -> GAAAATTAGTA
TGAAATGCGGA -> GAAATGCGGAA
TGAACATCGCT -> GAACATCGCTG
TGAACCGCCCT -> GAACCGCCCTA
TGAACTCGGAT -> GAACTCGGATG
TGAAGGGCGAC -> GAAGGGCGACT
TGAAGGTGTAC -> GAAGGTGTACA
TGAAGTCAGAT -> GAAGTCAGATA
TGAATAGAATG -> GAATAGAATGC
TGAATGTGAAT -> GAATGTGAATA
TGAATTATAAG -> GAATTATAAGT
TGAATTCGTCG -> GAATTCGTCGA
TGACAAGGATA -> GACAAGGATAC
TGACAATGTAG -> GACAATGTAGA
TGACAGCTGCT -> GACAGCTGCTC
TGACATAACAG -> GACATAACAGG
TGACATAGAGA -> GACATAGAGAT
TGACATTTGAG -> GACATTTGAGA
TGACCCCATAG -> GACCCCATAGA
TGAGAATTCTA -> GAGAATTCTAG
TGAGACACTAA -> GAGACACTAAT
TGAGATCACGC -> GAGATCACGCC
TGAGCAAGCAG -> GAGCAAGCAGT
TGAGCCTGGAT -> GAGCCTGGATA
TGAGCTACTCC -> GAGCTACTCCG
TGAGTAAGTCA -> GAGTAAGTCAA
TGATCGTCGCC -> GATCGTCGCCC
TGATCTCAAGT -> GATCTCAAGTG
TGATGAACATC -> GATGAACATCG
TGATGAAGTCA -> GATGAAGTCAG
TGATGAGCAAG -> GATGAGCAAGC
TGATTAATGCC -> GATTAATGCCT
TGATTGGTCCC -> GATTGGTCCCG
TGATTTTGGAT -> GATTTTGGATA
TGCAAATTAGC -> GCAAATTAGCC
TGCAACTTTAG -> GCAACTTTAGG
TGCAATCCGCA -> GCAATCCGCAA
TGCACTACGGT -> GCACTACGGTC
TGCACTATAAT -> GCACTATAATC
TGCAGATACGT -> GCAGATACGTT
TGCATTAGCTA -> GCATTAGCTAG
TGCATTTGCAT -> GCATTTGCATT
TGCCAGGGGTA -> GCCAGGGGTAA
TGCCCTGTGGA -> GCCCTGTGGAC
TGCCTCTCGTA -> GCCTCTCGTAA
TGCCTGAGATC -> GCCTGAGATCA
TGCCTTGTCCA -> GCCTTGTCCAT
TGCGAAGACCC -> GCGAAGACCCC
TGCGAGGACTA -> GCGAGGACTAT
TGCGCCCGATC -> GCGCCCGATCG
TGCGGAATCTC -> GCGGAATCTCG
TGCGGTCTCGA -> GCGGTCTCGAA
TGCGTCGATAG -> GCGTCGATAGA
TGCGTTGGGCG -> GCGTTGGGCGG
TGCTCACAAGT -> GCTCACAAGTG
TGCTCAGCGTC -> GCTCAGCGTCC
TGCTCGGCATC -> GCTCGGCATCG
TGCTCGTGGCG -> GCTCGTGGCGA
TGCTGGAAGCC -> GCTGGAAGCCC
TGCTGTAGCTG -> GCTGTAGCTGC
TGCTTCCTCCA -> GCTTCCTCCAG
TGGAACGCGCG -> GGAACGCGCGA
TGGAAGACATC -> GGAAGACATCT
TGGAAGCCCCG -> GGAAGCCCCGT
TGGACCCCGTG -> GGACCCCGTGC
TGGACGCAAGG -> GGACGCAAGGC
TGGACGCGCTC -> GGACGCGCTCG
TGGATACGTAA -> GGATACGTAAG
TGGATAGGCTA -> GGATAGGCTAC
TGGATCATTCT -> GGATCATTCTA
TGGATCTCTGT -> GGATCTCTGTA
TGGCCATATGT -> GGCCATATGTG
TGGCGATTAGA -> GGCGATTAGAA
TGGGAATAAAA -> GGGAATAAAAC
TGGGCAGCGAC -> GGGCAGCGACT
TGGGCGGAGCC -> GGGCGGAGCCT
TGGGCTTCCGT -> GGGCTTCCGTA
TGGGGGGATTG -> GGGGGGATTGT
TGGGTCCGCCA -> GGGTCCGCCAC
TGGTACACCCG -> GGTACACCCGA
TGGTCCCAGTT -> GGTCCCAGTTG
TGGTCCCGCTA -> GGTCCCGCTAG
TGGTTTTTCTG -> GGTTTTTCTGT
TGTACAGACTA -> GTACAGACTAG
TGTAGAATTCG -> GTAGAATTCGT
TGTAGCCGTGC -> GTAGCCGTGCA
TGTAGCTGCAA -> GTAGCTGCAAT
TGTAGGACTCC -> GTAGGACTCCT
TGTATAACAAG -> GTATAACAAGA
TGTATGCTCGG -> GTATGCTCGGC
TGTATTTTTTG -> GTATTTTTTGA
TGTCATATGCG -> GTCATATGCGA
TGTCATTCCGT -> GTCATTCCGTT
TGTCATTGAAC -> GTCATTGAACC
TGTCCATGCCT -> GTCCATGCCTC
TGTCCCACGTC -> GTCCCACGTCC
TGTCCGTAGGG -> GTCCGTAGGGA
TGTCGTAAGCT -> GTCGTAAGCTG
TGTCTGCGTTG -> GTCTGCGTTGG
TGTCTTAATTA -> GTCTTAATTAA
TGTGAAAATAC -> GTGAAAATACA
TGTGAATAGAA -> GTGAATAGAAT
TGTGAGACACT -> GTGAGACACTA
TGTGATCTCAA -> GTGATCTCAAG
TGTGCCCTGTG -> GTGCCCTGTGG
TGTGCGAGGAC -> GTGCGAGGACT
TGTGCTCACAA -> GTGCTCACAAG
TGTGGACGCGC -> GTGGACGCGCT
TGTGTAGGACT -> GTGTAGGACTC
TGTGTATAACA -> GTGTATAACAA
TGTGTGAGACA -> GTGTGAGACAC
TGTGTGCGAGG -> GTGTGCGAGGA
TGTTAAGGCGC -> GTTAAGGCGCG
TGTTCTTCTAC -> GTTCTTCTACG
TGTTTCGATCT -> GTTTCGATCTT
TGTTTTCTACA -> GTTTTCTACAC
TTAAAGATAAT -> TAAAGATAATA
TTAAAGTCGGC -> TAAAGTCGGCG
TTAAGAGCCAG -> TAAGAGCCAGG
TTAAGCTACAT -> TAAGCTACATC
TTAAGGCGCGC -> TAAGGCGCGCA
TTAAGTCAGGA -> TAAGTCAGGAG
TTAATGCCTTG -> TAATGCCTTGT
TTAATTAAAGA -> TAATTAAAGAT
TTACGGGAGGG -> TACGGGAGGGT
TTACGGTATAG -> TACGGTATAGA
TTACGTGGTCC -> TACGTGGTCCC
TTAGAACCGTG -> TAGAACCGTGA
TTAGATATTCA -> TAGATATTCAG
TTAGCCTGTCG -> TAGCCTGTCGT
TTAGCGGATCC -> TAGCGGATCCA
TTAGCGGGGGC -> TAGCGGGGGCC
TTAGCTAGGGA -> TAGCTAGGGAA
TTAGGGAATAA -> TAGGGAATAAT
TTAGGGTTCGC -> TAGGGTTCGCA
TTAGTAATATC -> TAGTAATATCG
TTATAAGTCTC -> TATAAGTCTCG
TTATAGGGCAG -> TATAGGGCAGC
TTATCGAAACC -> TATCGAAACCA
TTATCGACCGG -> TATCGACCGGG
TTATCGCGTCA -> TATCGCGTCAA
TTATGAATGTG -> TATGAATGTGA
TTATGAATTAT -> TATGAATTATA
TTATGCAACTT -> TATGCAACTTT
TTATTTGACAT -> TATTTGACATA
TTCAACCACAA -> TCAACCACAAC
TTCAGATTCCT -> TCAGATTCCTT
TTCAGTTCCTA -> TCAGTTCCTAT
TTCATAAAATT -> TCATAAAATTC
TTCCGGGCACG -> TCCGGGCACGA
TTCCGTAAATC -> TCCGTAAATCT
TTCCGTTTAAG -> TCCGTTTAAGC
TTCCTATCTGA -> TCCTATCTGAA
TTCCTCCAGGC -> TCCTCCAGGCA
TTCCTTAGGGT -> TCCTTAGGGTT
TTCGACGCGTG -> TCGACGCGTGC
TTCGATCTTTT -> TCGATCTTTTA
TTCGCAGATAC -> TCGCAGATACG
TTCGCATCGTG -> TCGCATCGTGG
TTCGGGTAGTC -> TCGGGTAGTCC
TTCGTCGACTA -> TCGTCGACTAA
TTCGTGTCATT -> TCGTGTCATTG
TTCGTTCCGGG -> TCGTTCCGGGC
TTCGTTTTATG -> TCGTTTTATGA
TTCTAACTGGG -> TCTAACTGGGC
TTCTAAGCAAA -> TCTAAGCAAAC
TTCTACACGAT -> TCTACACGATT
TTCTACGCATG -> TCTACGCATGC
TTCTAGCCCAG -> TCTAGCCCAGG
TTCTGACAATG -> TCTGACAATGT
TTCTGTGTATA -> TCTGTGTATAA
TTCTGTGTGCG -> TCTGTGTGCGA
TTCTTAGCGGG -> TCTTAGCGGGG
TTCTTCTACGC -> TCTTCTACGCA
TTCTTTTTGGG -> TCTTTTTGGGA
TTGAACCGCCC -> TGAACCGCCCT
TTGACATAGAG -> TGACATAGAGA
TTGACATTTGA -> TGACATTTGAG
TTGACCCCATA -> TGACCCCATAG
TTGAGAATTCT -> TGAGAATTCTA
TTGAGCCTGGA -> TGAGCCTGGAT
TTGAGTAAGTC -> TGAGTAAGTCA
TTGATGAGCAA -> TGATGAGCAAG
TTGATTGGTCC -> TGATTGGTCCC
TTGCATTAGCT -> TGCATTAGCTA
TTGGATAGGCT -> TGGATAGGCTA
TTGGGAATAAA -> TGGGAATAAAA
TTGGGCGGAGC -> TGGGCGGAGCC
TTGGGTCCGCC -> TGGGTCCGCCA
TTGGTCCCGCT -> TGGTCCCGCTA
TTGTATGCTCG -> TGTATGCTCGG
TTGTATTTTTT -> TGTATTTTTTG
TTGTCCATGCC -> TGTCCATGCCT
TTGTCTTAATT -> TGTCTTAATTA
TTGTGCCCTGT -> TGTGCCCTGTG
TTGTGTGAGAC -> TGTGTGAGACA
TTGTTCTTCTA -> TGTTCTTCTAC
TTGTTTCGATC -> TGTTTCGATCT
TTTAAGAGCCA -> TTAAGAGCCAG
TTTAAGCTACA -> TTAAGCTACAT
TTTAGGGAATA -> TTAGGGAATAA
TTTATCGAAAC -> TTATCGAAACC
TTTATGAATGT -> TTATGAATGTG
TTTCAACCACA -> TTCAACCACAA
TTTCGATCTTT -> TTCGATCTTTT
TTTCGTTCCGG -> TTCGTTCCGGG
TTTCTACACGA -> TTCTACACGAT
TTTCTGTGTAT -> TTCTGTGTATA
TTTGACATAGA -> TTGACATAGAG
TTTGAGAATTC -> TTGAGAATTCT
TTTGAGTAAGT -> TTGAGTAAGTC
TTTGCATTAGC -> TTGCATTAGCT
TTTGGATAGGC -> TTGGATAGGCT
TTTGGGAATAA -> TTGGGAATAAA
TTTGGGTCCGC -> TTGGGTCCGCC
TTTGTATTTTT -> TTGTATTTTTT
TTTGTGTGAGA -> TTGTGTGAGAC
TTTGTTCTTCT -> TTGTTCTTCTA
TTTGTTTCGAT -> TTGTTTCGATC
TTTTATCGAAA -> TTTATCGAAAC
TTTTATGAATG -> TTTATGAATGT
TTTTCTACACG -> TTTCTACACGA
TTTTCTGTGTA -> TTTCTGTGTAT
TTTTGAGTAAG -> TTTGAGTAAGT
TTTTGGATAGG -> TTTGGATAGGC
TTTTGGGAATA -> TTTGGGAATAA
TTTTGGGTCCG -> TTTGGGTCCGC
TTTTGTATTTT -> TTTGTATTTTT
TTTTTCTGTGT -> TTTTCTGTGTA
TTTTTGAGTAA -> TTTTGAGTAAG
TTTTTGGGAAT -> TTTTGGGAATA
TTTTTTGAGTA -> TTTTTGAGTAA
